aaoarx1	Aaosphaeria arxii
abobie2	Abortiporus biennis
absgla1	Absidia glauca
absrep1	Absidia repens
acaing1	Acaromyces ingoldii
acastr1	Acarospora strigata
acemac1	Acephala macrosclerotiorum
aciric2	Acidomyces richmondensis
acisp.1	Acidomyces sp.
acrchr1	Acremonium chrysogenum
actamb1	Actinomortierella ambigua
actamb2	Actinomortierella ambigua
actamb3	Actinomortierella ambigua
actwol1	Actinomortierella wolfii
actwol2	Actinomortierella wolfii
agabis1	Agaricus bisporus
agabis2	Agaricus bisporus
agabis3	Agaricus bisporus
agraeg1	Agrocybe aegerita
agrped1	Agrocybe pediades
akalec1	Akanthomyces lecanii
akalec2	Akanthomyces lecanii
alefal1	Alectoria fallacina
altals1	Alternaria alstroemeriae
altalt10	Alternaria alternata
altalt11	Alternaria alternata
altalt12	Alternaria alternata
altalt13	Alternaria alternata
altalt14	Alternaria alternata
altalt4	Alternaria alternata
altalt5	Alternaria alternata
altalt6	Alternaria alternata
altalt7	Alternaria alternata
altalt8	Alternaria alternata
altalt9	Alternaria alternata
altarb1	Alternaria arborescens
altarb2	Alternaria arborescens
altarb3	Alternaria arborescens
altarb4	Alternaria arborescens
altarb5	Alternaria arborescens
altarb6	Alternaria arborescens
altarb7	Alternaria arborescens
altatr1	Alternaria atra
altatr2	Alternaria atra
altbra1	Alternaria brassicicola
altbra2	Alternaria brassicicola
altbra3	Alternaria brassicae
altbur1	Alternaria burnsii
altcon1	Alternaria consortialis
altgai1	Alternaria gaisen
altgan1	Alternaria gansuensis
altgan2	Alternaria gansuensis
altlon1	Alternaria longipes
altpan1	Alternaria panax
altros1	Alternaria rosae
altros2	Alternaria rosae
altsol1	Alternaria solani
altsol2	Alternaria solani
altsp.4	Alternaria sp.
altten1	Alternaria tenuissima
altten2	Alternaria tenuissima
altten3	Alternaria tenuissima
altten4	Alternaria tenuissima
altten5	Alternaria tenuissima
altten6	Alternaria tenuissima
altten7	Alternaria tenuissima
altten8	Alternaria tenuissima
amabis1	Amanita bisporigera
amabru1	Amanita brunnescens
amacit2	Amanita citrina
amaino1	Amanita inopinata
amajac1	Amanita jacksonii
amamus4	Amanita muscaria
amamus5	Amanita muscaria
amamus6	Amanita muscaria
amapha1	Amanita phalloides
amapol1	Amanita polypyramis
amapse1	Amanita pseudoporphyria
amareg1	Amanita regalis
amarub1	Amanita rubescens
amathi1	Amanita thiersii
ambphi1	Ambrosiozyma philentoma
amnlig1	Amniculicola lignicola
amores1	Amorphotheca resinae
ampqui1	Ampelomyces quisqualis
ampsp.1	Amphiamblys sp.
ampsp.2	Amphinema sp.
ampsp.3	Amphinema sp.
amycha1	Amylostereum chailletii
amyenc1	Amylocarpus encephaloides
amylap1	Amylocystis lapponica
anarob1	Anaeromyces robustus
annalg1	Anncaliia algerae
annalg2	Anncaliia algerae
annbov1	Annulohypoxylon bovei
annmae1	Annulohypoxylon maeteangense
annmin1	Annulohypoxylon minutellum
annmor1	Annulohypoxylon moriforme
annnit1	Annulohypoxylon nitens
annsty1	Annulohypoxylon stygium
anntru1	Annulohypoxylon truncatum
antflo1	Anthracocystis flocculosa
antflo2	Anthracocystis flocculosa
antloc1	Antonospora locustae
antser1	Antrodia serialis
apipor1	Apiotrichum porosum
aplpru1	Aplosporella prunicola
apooss1	Apophysomyces ossiformis
aposp.1	Apophysomyces sp.
aposp.2	Apophysomyces sp.
aposp.3	Apophysomyces sp.
armcep1	Armillaria cepistipes
armgal1	Armillaria gallica
armmel2	Armillaria mellea
armost1	Armillaria ostoyae
armsol1	Armillaria solidipes
artben1	Arthroderma benhamiae
artele1	Artolenzites elegans
artent1	Arthrobotrys entomopaga
artfla1	Arthrobotrys flagrans
artmat1	Arthromyces matolae
artoli1	Arthrobotrys oligospora
artunc1	Arthroderma uncinatum
ascapi1	Ascosphaera apis
ascimm1	Ascobolus immersus
asclen1	Ascochyta lentis
ascnig1	Ascodesmis nigricans
ascrab1	Ascochyta rabiei
ascrub1	Ascoidea rubescens
ascrub2	Ascoidea rubescens
ascsar1	Ascocoryne sarcoides
aspacu1	Aspergillus aculeatinus
aspacu2	Aspergillus aculeatus
aspacu3	Aspergillus aculeatinus
aspacu4	Aspergillus aculeatinus
aspaff1	Aspergillus aff.floccosus
aspalb1	Aspergillus albertensis
aspall1	Aspergillus alliaceus
aspall2	Aspergillus alliaceus
aspall3	Aspergillus alliaceus
aspamo1	Aspergillus amoenus
aspara1	Aspergillus arachidicola
aspara2	Aspergillus arachidicola
aspara3	Aspergillus arachidicola
aspasp1	Aspergillus sp.
aspasp10	Aspergillus sp.
aspasp11	Aspergillus sp.
aspasp12	Aspergillus sp.
aspasp13	Aspergillus sp.
aspasp2	Aspergillus sp.
aspasp3	Aspergillus sp.
aspasp4	Aspergillus sp.
aspasp5	Aspergillus sp.
aspasp6	Aspergillus sp.
aspasp7	Aspergillus sp.
aspasp8	Aspergillus sp.
aspasp9	Aspergillus sp.
aspave1	Aspergillus avenaceus
aspave2	Aspergillus avenaceus
aspawa1	Aspergillus awamori
aspawa2	Aspergillus awamori
aspber1	Aspergillus bertholletius
aspber2	Aspergillus bertholletiae
aspbom1	Aspergillus bombycis
aspbom2	Aspergillus bombycis
aspbra1	Aspergillus brasiliensis
aspbru1	Aspergillus brunneoviolaceus
aspbru2	Aspergillus brunneoviolaceus
aspbru3	Aspergillus brunneus
aspbru4	Aspergillus brunneus
aspbur1	Aspergillus burnettii
aspcae1	Aspergillus caelatus
aspcae2	Aspergillus caelatus
aspcal2	Aspergillus calidoustus
aspcal3	Aspergillus calidoustus
aspcam1	Aspergillus campestris
aspcam2	Aspergillus campestris
aspcan2	Aspergillus candidus
aspcan3	Aspergillus candidus
aspcar1	Aspergillus carbonarius
aspcej1	Aspergillus cejpii
aspche1	Aspergillus chevalieri
aspche2	Aspergillus chevalieri
aspcla2	Aspergillus clavatus
aspcla3	Aspergillus clavatus
aspcor2	Aspergillus coremiiformis
aspcor3	Aspergillus coremiiformis
aspcos2	Aspergillus costaricaensis
aspcos3	Aspergillus costaricaensis
aspcre1	Aspergillus creber
aspcri1	Aspergillus cristatus
aspcri2	Aspergillus cristatus
aspcri3	Aspergillus cristatus
aspcri4	Aspergillus cristatus
aspcri5	Aspergillus cristatus
aspcro1	Aspergillus croceus
aspele1	Aspergillus elegans
aspell1	Aspergillus ellipticus
aspell2	Aspergillus ellipticus
aspeuc1	Aspergillus eucalypticola
aspeuc2	Aspergillus eucalypticola
aspfel1	Aspergillus felis
aspfel2	Aspergillus felis
aspfij1	Aspergillus fijiensis
aspfij2	Aspergillus fijiensis
aspfis1	Aspergillus fischeri
aspfis2	Aspergillus fischeri
aspfis3	Aspergillus fischeri
aspfis4	Aspergillus fischeri
aspfis5	Aspergillus fischeri
aspfla10	Aspergillus flavus
aspfla11	Aspergillus flavus
aspfla12	Aspergillus flavus
aspfla13	Aspergillus flavus
aspfla14	Aspergillus flavus
aspfla4	Aspergillus flavus
aspfla5	Aspergillus flavus
aspfla6	Aspergillus flavus
aspfla7	Aspergillus flavus
aspfla8	Aspergillus flavus
aspfla9	Aspergillus flavus
aspflo1	Aspergillus floridensis
aspfum10	Aspergillus fumigatus
aspfum11	Aspergillus fumigatiaffinis
aspfum12	Aspergillus fumigatiaffinis
aspfum13	Aspergillus fumigatiaffinis
aspfum14	Aspergillus fumigatiaffinis
aspfum15	Aspergillus fumigatus
aspfum16	Aspergillus fumigatus
aspfum17	Aspergillus fumigatus
aspfum18	Aspergillus fumigatus
aspfum19	Aspergillus fumigatus
aspfum3	Aspergillus fumigatus
aspfum4	Aspergillus fumigatus
aspfum5	Aspergillus fumigatus
aspfum6	Aspergillus fumigatus
aspfum7	Aspergillus fumigatus
aspfum8	Aspergillus fumigatus
aspfum9	Aspergillus fumigatus
aspgla1	Aspergillus glaucus
asphan1	Aspergillus hancockii
asphet2	Aspergillus heteromorphus
asphet3	Aspergillus heteromorphus
asphir1	Aspergillus hiratsukae
asphir2	Aspergillus hiratsukae
asphom1	Aspergillus homomorphus
asphom2	Aspergillus homomorphus
aspibe1	Aspergillus ibericus
aspibe2	Aspergillus ibericus
aspinc1	Aspergillus incahuasiensis
aspind2	Aspergillus indologenus
aspind3	Aspergillus indologenus
aspjap1	Aspergillus japonicus
aspjap2	Aspergillus japonicus
aspjap3	Aspergillus japonicus
aspjen1	Aspergillus jensenii
aspkaw1	Aspergillus kawachii
asplat1	Aspergillus latus
asplat2	Aspergillus latus
asplat3	Aspergillus latus
asplat4	Aspergillus latus
asplat5	Aspergillus latus
asplat6	Aspergillus latus
asplat7	Aspergillus latus
asplen1	Aspergillus lentulus
asplen10	Aspergillus lentulus
asplen2	Aspergillus lentulus
asplen3	Aspergillus lentulus
asplen4	Aspergillus lentulus
asplen5	Aspergillus lentulus
asplen6	Aspergillus lentulus
asplen7	Aspergillus lentulus
asplen8	Aspergillus lentulus
asplen9	Aspergillus lentulus
asplep1	Aspergillus leporis
asplep2	Aspergillus leporis
aspluc10	Aspergillus luchuensis
aspluc11	Aspergillus luchuensis
aspluc12	Aspergillus luchuensis
aspluc13	Aspergillus luchuensis
aspluc2	Aspergillus luchuensis
aspluc3	Aspergillus luchuensis
aspluc4	Aspergillus luchuensis
aspluc5	Aspergillus luchuensis
aspluc6	Aspergillus luchuensis
aspluc7	Aspergillus luchuensis
aspluc8	Aspergillus luchuensis
aspluc9	Aspergillus luchuensis
aspmel1	Aspergillus melleus
aspmin1	Aspergillus minisclerotigenes
aspmin2	Aspergillus minisclerotigenes
aspmon1	Aspergillus montevidensis
aspmul3	Aspergillus mulundensis
aspnan1	Aspergillus nanangensis
aspneo7	Aspergillus neoniger
aspneo8	Aspergillus neoellipticus
aspneo9	Aspergillus neoniger
aspnid1	Aspergillus nidulans
aspnid3	Aspergillus nidulans
aspnid4	Aspergillus nidulans
aspnig10	Aspergillus niger
aspnig11	Aspergillus niger
aspnig12	Aspergillus niger
aspnig13	Aspergillus niger
aspnig14	Aspergillus niger
aspnig15	Aspergillus niger
aspnig16	Aspergillus niger
aspnig2	Aspergillus niger
aspnig3	Aspergillus niger
aspnig4	Aspergillus niger
aspnig5	Aspergillus niger
aspnig6	Aspergillus niger
aspnig7	Aspergillus niger
aspnig8	Aspergillus niger
aspnig9	Aspergillus niger
aspnom1	Aspergillus nomius
aspnom2	Aspergillus nomius
aspnom3	Aspergillus nomiae
aspnom4	Aspergillus nomiae
aspnov1	Aspergillus novoparasiticus
aspnov2	Aspergillus novofumigatus
aspnov3	Aspergillus novofumigatus
aspnov4	Aspergillus novoparasiticus
aspoch1	Aspergillus ochraceoroseus
aspoch2	Aspergillus ochraceoroseus
aspoch3	Aspergillus ochraceoroseus
aspoch4	Aspergillus ochraceoroseus
aspoch5	Aspergillus ochraceus
aspoch6	Aspergillus ochraceus
aspoer1	Aspergillus oerlinghausenensis
aspoli1	Aspergillus olivimuriae
aspory1	Aspergillus oryzae
aspory10	Aspergillus oryzae
aspory11	Aspergillus oryzae
aspory12	Aspergillus oryzae
aspory2	Aspergillus oryzae
aspory3	Aspergillus oryzae
aspory4	Aspergillus oryzae
aspory5	Aspergillus oryzae
aspory6	Aspergillus oryzae
aspory7	Aspergillus oryzae
aspory8	Aspergillus oryzae
aspory9	Aspergillus oryzae
asppar1	Aspergillus parvisclerotigenus
asppar10	Aspergillus parasiticus
asppar11	Aspergillus parasiticus
asppar12	Aspergillus parasiticus
asppar13	Aspergillus parasiticus
asppar14	Aspergillus parasiticus
asppar4	Aspergillus parasiticus
asppar5	Aspergillus parasiticus
asppar6	Aspergillus parasiticus
asppar7	Aspergillus parasiticus
asppar8	Aspergillus parasiticus
asppar9	Aspergillus parasiticus
aspper1	Aspergillus persii
asppho1	Aspergillus phoenicis
asppip1	Aspergillus piperis
asppip2	Aspergillus piperis
asppro1	Aspergillus protuberus
asppse10	Aspergillus pseudonomiae
asppse11	Aspergillus pseudoterreus
asppse12	Aspergillus pseudoterreus
asppse13	Aspergillus pseudotamarii
asppse14	Aspergillus pseudocaelatus
asppse15	Aspergillus pseudoviridinutans
asppse6	Aspergillus pseudonomius
asppse7	Aspergillus pseudotamarii
asppse8	Aspergillus pseudocaelatus
asppse9	Aspergillus pseudonomiae
asppuu1	Aspergillus puulaauensis
aspqua1	Aspergillus quadrilineatus
aspram2	Aspergillus rambellii
aspram3	Aspergillus rambellii
asprub1	Aspergillus ruber
aspsac1	Aspergillus saccharolyticus
aspsac2	Aspergillus saccharolyticus
aspscl2	Aspergillus sclerotiicarbonarius
aspscl3	Aspergillus sclerotioniger
aspscl4	Aspergillus sclerotialis
aspscl5	Aspergillus sclerotiorum
aspscl6	Aspergillus sclerotioniger
aspscl7	Aspergillus sclerotiicarbonarius
aspser1	Aspergillus sergii
aspser2	Aspergillus sergii
aspsoj1	Aspergillus sojae
aspsoj2	Aspergillus sojae
aspsoj3	Aspergillus sojae
aspsoj4	Aspergillus sojae
aspsoj5	Aspergillus sojae
aspsp.1	Aspergillus sp.
aspspi1	Aspergillus spinulosporus
aspspi2	Aspergillus spinulosporus
aspste3	Aspergillus steynii
aspste4	Aspergillus steynii
aspsyd1	Aspergillus sydowii
aspsyd2	Aspergillus sydowii
aspsyd3	Aspergillus sydowii
aspsyd4	Aspergillus sydowii
asptai1	Aspergillus taichungensis
asptai2	Aspergillus taichungensis
asptam1	Aspergillus tamarii
asptam2	Aspergillus tamarii
asptam3	Aspergillus tamarii
asptam4	Aspergillus tamarii
asptan1	Aspergillus tanneri
aspter1	Aspergillus terreus
aspter10	Aspergillus terreus
aspter2	Aspergillus terreus
aspter3	Aspergillus terreus
aspter4	Aspergillus terreus
aspter5	Aspergillus terreus
aspter6	Aspergillus terreus
aspter7	Aspergillus terreus
aspter8	Aspergillus terreus
aspter9	Aspergillus terreus
aspthe1	Aspergillus thermomutatus
asptra2	Aspergillus transmontanensis
asptra3	Aspergillus transmontanensis
asptri1	Aspergillus tritici
asptub1	Aspergillus tubingensis
asptub10	Aspergillus tubingensis
asptub2	Aspergillus tubingensis
asptub3	Aspergillus tubingensis
asptub4	Aspergillus tubingensis
asptub5	Aspergillus tubingensis
asptub6	Aspergillus tubingensis
asptub7	Aspergillus tubingensis
asptub8	Aspergillus tubingensis
asptub9	Aspergillus tubingensis
asptur1	Aspergillus turcosus
asptur2	Aspergillus turcosus
aspuda1	Aspergillus udagawae
aspuda2	Aspergillus udagawae
aspuda3	Aspergillus udagawae
aspuda4	Aspergillus udagawae
aspuda5	Aspergillus udagawae
aspuda6	Aspergillus udagawae
aspuda7	Aspergillus udagawae
aspung1	Aspergillus unguis
aspung2	Aspergillus unguis
aspung3	Aspergillus unguis
aspung4	Aspergillus unguis
aspust1	Aspergillus ustus
aspuva1	Aspergillus uvarum
aspuva2	Aspergillus uvarum
aspvad1	Aspergillus vadensis
aspvad2	Aspergillus vadensis
aspver1	Aspergillus versicolor
aspver2	Aspergillus versicolor
aspvio1	Aspergillus violaceofuscus
aspvio2	Aspergillus violaceofuscus
aspvir1	Aspergillus viridinutans
aspvir2	Aspergillus viridinutans
aspwel1	Aspergillus welwitschiae
aspwel2	Aspergillus welwitschiae
aspwel3	Aspergillus welwitschiae
aspwel4	Aspergillus welwitschiae
aspwel5	Aspergillus welwitschiae
aspwen1	Aspergillus wentii
aspwes1	Aspergillus westerdijkiae
aspwes2	Aspergillus westerdijkiae
aspzon1	Aspergillus zonatus
astodo1	Astraeus odoratus
astpar1	Asterophora parasitica
astsub1	Astrocystis sublimbata
athara1	Athelia arachnoidea
athara2	Athelia arachnoidea
athdec1	Athelia decipiens
athepi1	Athelia epiphylla
athter1	Athelia termitophila
athter2	Athelia termitophila
aulhed1	Aulographum hederae
auramp1	Auriculariopsis ampla
aurmel1	Aureobasidium melanogenum
aurmus1	Aureobasidium mustum
aurnam1	Aureobasidium namibiae
aurpul1	Aureobasidium pullulans
aurpul2	Aureobasidium pullulans
aurpul3	Aureobasidium pullulans
aurpul4	Aureobasidium pullulans
aurpul5	Aureobasidium pullulans
aurpul6	Aureobasidium pullulans
aursp.1	Aureobasidium sp.
aursp.2	Auriculariales sp.
aursub2	Aureobasidium subglaciale
aursub3	Auricularia subglabra
auruva1	Aureobasidium uvarum
aurvin1	Aureobasidium vineae
aurvul1	Auriscalpium vulgare
auspsi1	Austropuccinia psidii
babino1	Babjeviella inositovora
bacgig1	Bacidia gigantensis
basmer1	Basidiobolus meristosporus
batden1	Batrachochytrium dendrobatidis
batden2	Batrachochytrium dendrobatidis
batsal1	Batrachochytrium salamandrivorans
baucom1	Baudoinia compniacensis
baupan1	Baudoinia panamericana
beabas1	Beauveria bassiana
beabas2	Beauveria bassiana
beabro1	Beauveria brongniartii
bifade1	Bifiguratus adelaidae
bimnov1	Bimuria novae-zelandiae
bipmay1	Bipolaris maydis
bipmay2	Bipolaris maydis
bipory1	Bipolaris oryzae
bipsor1	Bipolaris sorokiniana
bipsor2	Bipolaris sorokiniana
bipzei1	Bipolaris zeicola
bismar1	Biscogniauxia marginata
bismed1	Biscogniauxia mediterranea
bismed2	Biscogniauxia mediterranea
bissp.1	Biscogniauxia sp.
bjeadu1	Bjerkandera adusta
blaar.1	Blastobotrys (Arxula)
blader2	Blastomyces dermatitidis
blader3	Blastomyces dermatitidis
blader4	Blastomyces dermatitidis
blader5	Blastomyces dermatitidis
blagil1	Blastomyces gilchristii
blapar1	Blastomyces parvus
blaper1	Blastomyces percursus
blasil1	Blastomyces silverae
blazon1	Blastosporella zonata
blugra3	Blumeria graminis
blugra4	Blumeria graminis
blugra5	Blumeria graminis
blugra6	Blumeria graminis
blugra7	Blumeria graminis
blugra9	Blumeria graminis
bluhor1	Blumeria hordei
blyhel1	Blyttiomyces helicus
boeexi1	Boeremia exigua
boledu1	Boletus edulis
boledu2	Boletus edulis
bolret1	Boletus reticuloceps
bonmes1	Bondarzewia mesenterica
botacl1	Botrytis aclada
botbot1	Botryobasidium botryosum
botbys1	Botrytis byssoidea
botcal1	Botryotinia calthae
botcin3	Botrytis cinerea
botcin4	Botrytis cinerea
botcin5	Botrytis cinerea
botcon1	Botryotinia convoluta
botdew1	Botrytis deweyae
botdot1	Botryosphaeria dothidea
botell1	Botrytis elliptica
botell2	Botrytis elliptica
botfra1	Botrytis fragariae
botgal1	Botrytis galanthina
botglo1	Botryotinia globosa
bothya1	Botrytis hyacinthi
botnar1	Botryotinia narcissicola
botpae1	Botrytis paeoniae
botpor1	Botrytis porri
botpor2	Botrytis porri
botsin1	Botrytis sinoallii
botsqu1	Botryotinia squamosa
bottul1	Botrytis tulipae
brebru10	Brettanomyces bruxellensis
brebru2	Brettanomyces bruxellensis
brebru3	Brettanomyces bruxellensis
brebru5	Brettanomyces bruxellensis
brebru6	Brettanomyces bruxellensis
brenaa1	Brettanomyces naardenensis
brenan1	Brettanomyces nanus
butros1	Butyriboletus roseoflavus
byscir1	Byssothecium circinans
bysspe1	Byssochlamys spectabilis
cadmal1	Cadophora malorum
cadsp.1	Cadophora sp.
cadsp.2	Cadophora sp.
caechu1	Caecomyces churrovis
calcor1	Calocera cornea
calmar1	Calycina marina
calvis1	Calocera viscosa
camtin1	Camillea tinctor
canafr1	Candida africana
canalb10	Candida albicans
canalb11	Candida albicans
canalb12	Candida albicans
canalb13	Candida albicans
canalb14	Candida albicans
canalb15	Candida albicans
canalb16	Candida albicans
canalb17	Candida albicans
canalb18	Candida albicans
canalb19	Candida albicans
canalb2	Candida albicans
canalb20	Candida albicans
canalb21	Candida albicans
canalb22	Candida albicans
canalb23	Candida albicans
canalb24	Candida albicans
canalb25	Candida albicans
canalb26	Candida albicans
canalb27	Candida albicans
canalb28	Candida albicans
canalb3	Candida albicans
canalb4	Candida albicans
canalb7	Candida albicans
canalb8	Candida albicans
canalb9	Candida albicans
cananz1	Cantharellus anzutake
canara1	Candida arabinofermentans
canaur1	Candida auris
canaur2	Candida auris
canaur3	Candida auris
canaur4	Candida auris
canaur5	Candida auris
canaur6	Candida auris
canaur7	Candida auris
canaur8	Candida auris
canboi1	Candida boidinii
cancal1	Candida californica
cancal2	Candida californica
candub1	Candida dubliniensis
canduo1	Candida duobushaemulonis
cangla1	Candida glabrata
cangla10	Candida glabrata
cangla11	Candida glabrata
cangla12	Candida glabrata
cangla13	Candida glabrata
cangla2	Candida glabrata
cangla3	Candida glabrata
cangla4	Candida glabrata
cangla5	Candida glabrata
cangla6	Candida glabrata
cangla7	Candida glabrata
cangla8	Candida glabrata
cangla9	Candida glabrata
canhae1	Candida haemuloni
canhae2	Candida haemuloni
canhae3	Candida haemuloni
caninc1	Candida inconspicua
canint1	Candida intermedia
canint2	Candida intermedia
canmal1	Candida maltosa
canmet1	Candida metapsilosis
canort1	Candida orthopsilosis
canpar1	Candida parapsilosis
canpse1	Candida pseudohaemulonii
cansub1	Candida subhashii
cantan1	Candida tanzawaensis
cantro1	Candida tropicalis
canvis1	Candida viswanathii
capcor1	Capronia coronata
capepi1	Capronia epimyces
capsem1	Capronia semiimmersa
catang1	Catenaria anguillulae
caupro1	Caulochytrium protostelioides
caupro2	Caulochytrium protostelioides
cengeo1	Cenococcum geophilum
cerber1	Cercospora berteroae
cerbet1	Cercospora beticola
cerbom1	Ceraceosorus bombacis
cerfim1	Ceratocystis fimbriata
cergua1	Ceraceosorus guamensis
cerkik1	Cercospora kikuchii
cerpla1	Ceratocystis platani
cersp.10	Ceratobasidium sp.
cersp.13	Ceratobasidium sp.
cersp.14	Ceratobasidium sp.
cersp.15	Ceratobasidium sp.
cersp.16	Ceratobasidium sp.
cersp.17	Ceratobasidium sp.
cersp.4	Ceratobasidium sp.
cersp.8	Ceratobasidium sp.
certhe1	Ceratobasidium theobromae
cerzea1	Cercospora zeae-maydis
cerzei1	Cercospora zeina
chafun1	Chaetomium funicola
chaglo1	Chaetomium globosum
chaglo2	Chaetomium globosum
chalon1	Chalara longipes
chasp.2	Chaetomium sp.
chasp.4	Chaetothyriales sp.
chasp.5	Chaetothyriales sp.
chasp.6	Chaetothyriales sp.
chasp.7	Chaetothyriales sp.
chasp.8	Chaetomium sp.
chathe1	Chaetomium thermophilum
chivir1	Chiua virens
chlaer1	Chlorociboria aeruginascens
choven1	Choiromyces venosus
chycon1	Chytriomyces confervae
citmat1	Citeromyces matritensis
claaff1	Claviceps aff.
claaff2	Claviceps aff.
claafr1	Claviceps africana
claaqu1	Clavariopsis aquatica
claaru1	Claviceps arundinis
claaru2	Claviceps arundinis
claban1	Cladophialophora bantiana
clacap1	Claviceps capensis
clacar1	Cladophialophora carrionii
clacit1	Claviceps citrina
clacyp1	Claviceps cyperi
cladig1	Claviceps digitariae
claely1	Clathrospora elynae
claful1	Cladosporium fulvum
clagra1	Cladonia grayi
clahum1	Claviceps humidiphila
claimm1	Cladophialophora immunda
clalov1	Claviceps lovelessii
clalus2	Clavispora lusitaniae
clamax1	Claviceps maximensis
clamon1	Claviceps monticola
clapaz1	Claviceps pazoutovae
clapsa1	Cladophialophora psammophila
clapur1	Claviceps purpurea
clapus1	Claviceps pusilla
clapyx1	Clavicorona pyxidata
clasor1	Claviceps sorghi
clasp.1	Clavulina sp.
clasp.10	Claviceps sp.
clasp.11	Claviceps sp.
clasp.2	Claviceps sp.
clasp.3	Claviceps sp.
clasp.4	Claviceps sp.
clasp.5	Claviceps sp.
clasp.6	Claviceps sp.
clasp.7	Claviceps sp.
clasp.8	Claviceps sp.
clasp.9	Claviceps sp.
claspa1	Claviceps spartinae
clasph1	Cladosporium sphaerospermum
clayeg1	Cladophialophora yegresii
cligib1	Clitocybe gibba
cloaqu1	Clohesyomyces aquaticus
clobys1	Clonostachys byssicola
clorhi1	Clonostachys rhizophaga
closol1	Clonostachys solani
coccar1	Cochliobolus carbonum
cocimm1	Coccidioides immitis
cocimm2	Coccidioides immitis
cocimm3	Coccidioides immitis
cocimm4	Coccidioides immitis
coclun1	Cochliobolus lunatus
cocmiy1	Cochliobolus miyabeanus
cocpos2	Coccidioides posadasii
cocpos3	Coccidioides posadasii
cocpos4	Coccidioides posadasii
cocpos5	Coccidioides posadasii
cocsat1	Cochliobolus sativus
cocvic1	Cochliobolus victoriae
coerev1	Coemansia reversa
colaen1	Colletotrichum aenigma
colasi1	Colletotrichum asianum
colcam1	Colletotrichum camelliae
colchl1	Colletotrichum chlorophyti
colcra1	Coleophoma crateriformis
colcyl1	Coleophoma cylindrospora
colfio1	Colletotrichum fioriniae
colfru1	Colletotrichum fructicola
colfru2	Colletotrichum fructicola
colfru3	Colletotrichum fructicola
colfru4	Colletotrichum fructicola
colfru5	Colletotrichum fructicola
colfru6	Colletotrichum fructicola
colfru7	Colletotrichum fructicola
colglo1	Colletotrichum gloeosporioides
colgra1	Colletotrichum graminicola
colhig1	Colletotrichum higginsianum
colinc1	Colletotrichum incanum
colkar1	Colletotrichum karsti
colmus1	Colletotrichum musicola
colnym1	Colletotrichum nymphaeae
colorb1	Colletotrichum orbiculare
colorb2	Colletotrichum orbiculare
colorc1	Colletotrichum orchidophilum
colplu1	Colletotrichum plurivorum
colsal1	Colletotrichum salicis
colsco1	Colletotrichum scovillei
colshi1	Colletotrichum shisoi
colsia1	Colletotrichum siamense
colsia2	Colletotrichum siamense
colsia3	Colletotrichum siamense
colsia4	Colletotrichum siamense
colsia5	Colletotrichum siamense
colsid1	Colletotrichum sidae
colsim1	Colletotrichum simmondsii
colsoj1	Colletotrichum sojae
colspi1	Colletotrichum spinosum
colsub1	Colletotrichum sublineola
coltan1	Colletotrichum tanaceti
coltof2	Colletotrichum tofieldiae
coltri1	Colletotrichum trifolii
coltro1	Colletotrichum tropicale
coltru1	Colletotrichum truncatum
colvin1	Colletotrichum viniferum
conapo1	Coniosporium apollinis
concor1	Conidiobolus coronatus
conlig1	Coniochaeta ligniaria
conoli1	Coniophora olivacea
conpul1	Coniochaeta pulveracea
conput1	Coniophora puteana
consp.1	Coniochaeta sp.
copang1	Coprinellus angulatus
copcin1	Coprinopsis cinerea
copcin2	Coprinopsis cinerea
copmar1	Coprinopsis marcescibilis
copmic1	Coprinellus micaceus
copsp.1	Coprinopsis sp.
corcas1	Corynespora cassiicola
corcas2	Corynespora cassiicola
corfum1	Cordyceps fumosorosea
corgla1	Cortinarius glaucopus
corjav1	Cordyceps javanica
corjav2	Cordyceps javanica
cormil1	Cordyceps militaris
corsp.1	Cordyceps sp.
crafun1	Crassisporium funariophilum
crevar1	Crepidotus variabilis
croque1	Cronartium quercuum
crulae1	Crucibulum laeve
cryamy1	Cryptococcus amylolentus
cryamy2	Cryptococcus amylolentus
crycf.1	Cryptococcus cf.
crycur1	Cryptococcus curvatus
crydep1	Cryptococcus depauperatus
crydep2	Cryptococcus depauperatus
cryflo1	Cryptococcus floricola
crygat10	Cryptococcus gattii
crygat11	Cryptococcus gattii
crygat12	Cryptococcus gattii
crygat13	Cryptococcus gattii
crygat14	Cryptococcus gattii
crygat15	Cryptococcus gattii
crygat16	Cryptococcus gattii
crygat17	Cryptococcus gattii
crygat2	Cryptococcus gattii
crygat3	Cryptococcus gattii
crygat4	Cryptococcus gattii
crygat5	Cryptococcus gattii
crygat6	Cryptococcus gattii
crygat7	Cryptococcus gattii
crygat8	Cryptococcus gattii
crygat9	Cryptococcus gattii
crymin1	Cryomyces minteri
cryneo1	Cryptococcus neoformans
cryneo10	Cryptococcus neoformans
cryneo11	Cryptococcus neoformans
cryneo12	Cryptococcus neoformans
cryneo13	Cryptococcus neoformans
cryneo14	Cryptococcus neoformans
cryneo15	Cryptococcus neoformans
cryneo16	Cryptococcus neoformans
cryneo17	Cryptococcus neoformans
cryneo18	Cryptococcus neoformans
cryneo19	Cryptococcus neoformans
cryneo2	Cryptococcus neoformans
cryneo20	Cryptococcus neoformans
cryneo21	Cryptococcus neoformans
cryneo22	Cryptococcus neoformans
cryneo23	Cryptococcus neoformans
cryneo24	Cryptococcus neoformans
cryneo25	Cryptococcus neoformans
cryneo26	Cryptococcus neoformans
cryneo27	Cryptococcus neoformans
cryneo28	Cryptococcus neoformans
cryneo29	Cryptococcus neoformans
cryneo3	Cryptococcus neoformans
cryneo30	Cryptococcus neoformans
cryneo31	Cryptococcus neoformans
cryneo32	Cryptococcus neoformans
cryneo33	Cryptococcus neoformans
cryneo34	Cryptococcus neoformans
cryneo35	Cryptococcus neoformans
cryneo36	Cryptococcus neoformans
cryneo37	Cryptococcus neoformans
cryneo38	Cryptococcus neoformans
cryneo39	Cryptococcus neoformans
cryneo4	Cryptococcus neoformans
cryneo40	Cryptococcus neoformans
cryneo41	Cryptococcus neoformans
cryneo42	Cryptococcus neoformans
cryneo5	Cryptococcus neoformans
cryneo6	Cryptococcus neoformans
cryneo7	Cryptococcus neoformans
cryneo8	Cryptococcus neoformans
cryneo9	Cryptococcus neoformans
crypar1	Cryphonectria parasitica
cryter1	Cryptococcus terricola
crywin1	Cryptococcus wingfieldii
cucber1	Cucurbitaria berberidis
cucdik1	Cucumispora dikerogammari
cudaci1	Cudoniella acicularis
curkus1	Curvularia kusanoi
cutole1	Cutaneotrichosporon oleaginosum
cutole2	Cutaneotrichosporon oleaginosum
cyastr1	Cyathus striatus
cybfab1	Cyberlindnera fabianii
cybjad1	Cyberlindnera jadinii
cylhub1	Cylindrodendrum hubeiense
cyloli1	Cylindrocarpon olidum
cyltor1	Cylindrobasidium torrendii
cyltor2	Cylindrobasidium torrendii
cypeur1	Cyphellophora europaea
cysmin1	Cystobasidium minutum
cytleu1	Cytospora leucostoma
cytmel1	Cytidiella melzeri
daccio1	Dactylellina cionopaga
daccyl1	Dactylella cylindrospora
dacest1	Dactylonectria estremocensis
dachap1	Dactylellina haptotyla
dacmac1	Dactylonectria macrodidyma
dacpri1	Dacryopinax primogenitus
daeque1	Daedalea quercina
dalbam1	Daldinia bambusicola
dalcal1	Daldinia caldariorum
dalchi1	Daldinia childiae
daldec1	Daldinia decipiens
dalesc1	Daldinia eschscholtzii
dalesc2	Daldinia eschscholtzii
dalgra1	Daldinia grandis
dalloc2	Daldinia loculata
dalloc3	Daldinia loculata
dalsp.1	Daldinia sp.
dalsp.2	Daldinia sp.
dalver1	Daldinia vernicosa
debfab1	Debaryomyces fabryi
debhan1	Debaryomyces hansenii
decgau1	Decorospora gaudefroyi
dekbru1	Dekkera bruxellensis
delcon1	Delitschia confertaspora
delstr1	Delphinella strobiligena
denbis1	Dendrothele bispora
denfra1	Dentipellis fragilis
dennan1	Dendryphion nanum
densp.1	Dentipellis sp.
diaamp1	Diaporthe ampelina
diabat1	Diaporthe batatas
diacit1	Diaporthe citri
diahel1	Diaporthe helianthi
dibbae1	Dibaeis baeomyces
dicmue1	Dictyocoela muelleri
dicroe1	Dictyocoela roeselum
dicsqu1	Dichomitus squalens
dicsqu2	Dichomitus squalens
dicsqu3	Dichomitus squalens
dicsqu4	Dichomitus squalens
didena1	Didymosphaeria enalia
didexi1	Didymella exigua
didhet1	Didymella heteroderae
didker1	Didymella keratinophila
didzea1	Didymella zeae-maydis
dimcri1	Dimargaris cristalligena
dipcor1	Diplodia corticola
dipros1	Diplocarpon rosae
dipser1	Diplodia seriata
disaci1	Dissoconium aciculare
disglo1	Dissophora globulifera
disglo2	Dissophora globulifera
diurug1	Diutina rugosa
divepi1	Diversispora epigaea
dotsep1	Dothistroma septosporum
dotsym1	Dothidotthia symphoricarpi
drebro1	Drechslerella brochopaga
drecon1	Drechmeria coniospora
dreste1	Drechslerella stenobrocha
durrog1	Durotheca rogersii
earsca1	Earliella scabrosa
edhaed1	Edhazardia aedis
elagra1	Elaphomyces granulatus
elagra2	Elaphomyces granulatus
elsamp1	Elsinoe ampelina
elsaus1	Elsinoe australis
elsaus2	Elsinoe australis
elsbat1	Elsinoe batatas
elsfaw1	Elsinoe fawcettii
emeafr1	Emergomyces africanus
emepas1	Emergomyces pasteurianus
emepas2	Emergomyces pasteurianus
emesp.1	Emericellopsis sp.
emmcre1	Emmonsia crescens
emmcre2	Emmonsia crescens
emmpar1	Emmonsia parva
enccun1	Encephalitozoon cuniculi
enccun2	Encephalitozoon cuniculi
enchel1	Encephalitozoon hellem
encint1	Encephalitozoon intestinalis
encrom1	Encephalitozoon romaleae
endpal1	Endocarpon pallidulum
endpus1	Endocarpon pusillum
endsp.1	Endogone sp
endsp.2	Endogone sp.
entbel1	Entomortierella beljakovae
entbie1	Enterocytozoon bieneusi
entcan1	Enterospora canceri
entchl1	Entomortierella chlamydospora
entchl2	Entomortierella chlamydospora
enthep1	Enterocytozoon hepatopenaei
entlig1	Entomortierella lignicola
entmus1	Entomophthora muscae
epifes1	Epichloe festucae
epityp1	Epithele typhae
erebil1	Eremomyces bilateralis
erecym1	Eremothecium cymbalariae
eregos1	Eremothecium gossypii
eregos2	Eremothecium gossypii
eresin1	Eremothecium sinecaudum
erynec1	Erysiphe necator
erypul1	Erysiphe pulchra
escweb1	Escovopsis weberi
eurrub1	Eurotium rubrum
eutlat1	Eutypa lata
exigla1	Exidia glandulosa
exoaqu1	Exophiala aquamarina
exoder1	Exophiala dermatitidis
exoder2	Exophiala dermatitidis
exomes1	Exophiala mesophila
exooli1	Exophiala oligosperma
exosid1	Exophiala sideris
exospi1	Exophiala spinifera
exoxen1	Exophiala xenobiotica
exstur1	Exserohilum turcica
fibpsy1	Fibulorhizoctonia psychrophila
fibrad1	Fibroporia radiculosa
fibsp.1	Fibularhizoctonia sp.
filflo1	Filobasidium floriforme
fishep1	Fistulina hepatica
flaaln1	Flammula alnicola
fombet1	Fomitopsis betulina
fomfom1	Fomes fomentarius
fommed1	Fomitiporia mediterranea
fompin1	Fomitopsis pinicola
fonere1	Fonsecaea erecta
fonmon1	Fonsecaea monophora
fonmul1	Fonsecaea multimorphosa
fonnub1	Fonsecaea nubica
fonped1	Fonsecaea pedrosoi
friend1	Friedmanniomyces endolithicus
frisim1	Friedmanniomyces simplex
funsp.1	fungal sp.
funsp.2	fungal sp.
furboo1	Furculomyces boomerangus
fusaca1	Fusarium acaciae-mearnsii
fusaca2	Fusarium acaciae-mearnsii
fusaca3	Fusarium acaciae-mearnsii
fusaca4	Fusarium acaciae-mearnsii
fusacu1	Fusarium acutatum
fusacu2	Fusarium acuminatum
fusaet1	Fusarium aethiopicum
fusaga1	Fusarium agapanthi
fusaga2	Fusarium agapanthi
fusalb1	Fusarium albosuccineum
fusalb2	Fusarium albidum
fusalg1	Fusarium algeriense
fusalg2	Fusarium algeriense
fusamb1	Fusarium ambrosium
fusang1	Fusarium anguioides
fusann1	Fusarium annulatum
fusann2	Fusarium annulatum
fusann3	Fusarium annulatum
fusann4	Fusarium annulatum
fusann5	Fusarium annulatum
fusant1	Fusarium anthophilum
fusarm1	Fusarium armeniacum
fusarm2	Fusarium armeniacum
fusasi1	Fusarium asiaticum
fusasi2	Fusarium asiaticum
fusasi3	Fusarium asiaticum
fusasi4	Fusarium asiaticum
fusaus1	Fusarium austroafricanum
fusaus2	Fusarium austroamericanum
fusaus3	Fusarium austroamericanum
fusaus4	Fusarium austroamericanum
fusaus5	Fusarium austroamericanum
fusaus6	Fusarium austroamericanum
fusave1	Fusarium avenaceum
fusave2	Fusarium avenaceum
fusave3	Fusarium avenaceum
fusave4	Fusarium avenaceum
fusave5	Fusarium avenaceum
fusave6	Fusarium avenaceum
fusave7	Fusarium avenaceum
fusave8	Fusarium avenaceum
fusave9	Fusarium avenaceum
fusayw1	Fusarium aywerte
fusazu1	Fusarium azukicola
fusbab1	Fusarium babinda
fusbab2	Fusarium babinda
fusbac1	Fusarium bactridioides
fusbeg1	Fusarium begoniae
fusbeo1	Fusarium beomiforme
fusboo1	Fusarium boothii
fusboo2	Fusarium boothii
fusboo3	Fusarium boothii
fusbra1	Fusarium brasiliense
fusbra2	Fusarium brasilicum
fusbra3	Fusarium brasilicum
fusbra4	Fusarium brachygibbosum
fusbre1	Fusarium brevicatenulatum
fusbuh1	Fusarium buharicum
fusbul1	Fusarium bulbicola
fusbul2	Fusarium bulbicola
fusbur1	Fusarium burgessii
fusbux1	Fusarium buxicola
fuscaa1	Fusarium caatingaense
fuscam1	Fusarium camptoceras
fuscer1	Fusarium cerealis
fuscer2	Fusarium cerealis
fuschl1	Fusarium chlamydosporum
fuscir1	Fusarium circinatum
fuscir2	Fusarium circinatum
fuscir3	Fusarium circinatum
fuscir4	Fusarium circinatum
fuscir5	Fusarium circinatum
fuscir6	Fusarium circinatum
fuscir7	Fusarium circinatum
fuscir8	Fusarium circinatum
fuscir9	Fusarium circinatum
fuscit1	Fusarium citri
fuscla1	Fusarium clavum
fuscof1	Fusarium coffeatum
fuscof2	Fusarium coffeatum
fuscoi1	Fusarium coicis
fuscom1	Fusarium commune
fuscom2	Fusarium commune
fuscom3	Fusarium commune
fuscon1	Fusarium concolor
fuscon2	Fusarium continuum
fuscon3	Fusarium concentricum
fuscor1	Fusarium cortaderiae
fuscor2	Fusarium cortaderiae
fuscor3	Fusarium cortaderiae
fuscor4	Fusarium cortaderiae
fuscor5	Fusarium cortaderiae
fuscul1	Fusarium culmorum
fuscul2	Fusarium culmorum
fuscul3	Fusarium culmorum
fuscul4	Fusarium culmorum
fuscul5	Fusarium culmorum
fuscul6	Fusarium culmorum
fuscun1	Fusarium cuneirostrum
fuscya1	Fusarium cyanostomum
fusdec1	Fusarium decemcellulare
fusden1	Fusarium denticulatum
fusdim1	Fusarium dimerum
fusdla1	Fusarium dlaminii
fusdom1	Fusarium domesticum
fusequ1	Fusarium equiseti
fusequ10	Fusarium equiseti
fusequ2	Fusarium equiseti
fusequ3	Fusarium equiseti
fusequ4	Fusarium equiseti
fusequ5	Fusarium equiseti
fusequ6	Fusarium equiseti
fusequ7	Fusarium equiseti
fusequ8	Fusarium equiseti
fusequ9	Fusarium equiseti
fuseuw1	Fusarium euwallaceae
fuseuw2	Fusarium euwallaceae
fusfal1	Fusarium falciforme
fusfla1	Fusarium flagelliforme
fusfla2	Fusarium flagelliforme
fusfla3	Fusarium flagelliforme
fusflo1	Fusarium floridanum
fusfoe1	Fusarium foetens
fusfra1	Fusarium fracticaudum
fusfuj1	Fusarium fujikuroi
fusfuj10	Fusarium fujikuroi
fusfuj2	Fusarium fujikuroi
fusfuj3	Fusarium fujikuroi
fusfuj4	Fusarium fujikuroi
fusfuj5	Fusarium fujikuroi
fusfuj6	Fusarium fujikuroi
fusfuj7	Fusarium fujikuroi
fusfuj8	Fusarium fujikuroi
fusfuj9	Fusarium fujikuroi
fusfus1	Fusarium sp.
fusfus10	Fusarium cf.
fusfus11	Fusarium cf.
fusfus12	Fusarium cf.
fusfus13	Fusarium cf.
fusfus14	Fusarium cf.
fusfus15	Fusarium cf.
fusfus16	Fusarium cf.
fusfus17	Fusarium cf.
fusfus18	Fusarium cf.
fusfus19	Fusarium cf.
fusfus2	Fusarium sp.
fusfus20	Fusarium cf.
fusfus21	Fusarium cf.
fusfus22	Fusarium cf.
fusfus23	Fusarium cf.
fusfus24	Fusarium cf.
fusfus25	Fusarium cf.
fusfus26	Fusarium cf.
fusfus27	Fusarium cf.
fusfus28	Fusarium cf.
fusfus29	Fusarium cf.
fusfus3	Fusarium sp.
fusfus30	Fusarium cf.
fusfus31	Fusarium cf.
fusfus32	Fusarium cf.
fusfus33	Fusarium cf.
fusfus34	Fusarium cf.
fusfus35	Fusarium sp.
fusfus36	Fusarium sp.
fusfus37	Fusarium sp.
fusfus38	Fusarium sp.
fusfus39	Fusarium sp.
fusfus4	Fusarium sp.
fusfus40	Fusarium sp.
fusfus41	Fusarium sp.
fusfus42	Fusarium sp.
fusfus43	Fusarium sp.
fusfus44	Fusarium sp.
fusfus45	Fusarium sp.
fusfus46	Fusarium sp.
fusfus47	Fusarium sp.
fusfus48	Fusarium sp.
fusfus49	Fusarium sp.
fusfus5	Fusarium cf.
fusfus50	Fusarium sp.
fusfus51	Fusarium sp.
fusfus52	Fusarium sp.
fusfus53	Fusarium sp.'flavolapis'
fusfus54	Fusarium sp.
fusfus55	Fusarium sp.
fusfus56	Fusarium sp.
fusfus57	Fusarium sp.
fusfus58	Fusarium sp.
fusfus59	Fusarium sp.
fusfus6	Fusarium cf.
fusfus60	Fusarium sp.
fusfus61	Fusarium sp.
fusfus62	Fusarium sp.
fusfus63	Fusarium sp.
fusfus64	Fusarium sp.
fusfus65	Fusarium sp.
fusfus7	Fusarium cf.
fusfus8	Fusarium cf.
fusfus9	Fusarium cf.
fusgad1	Fusarium gaditjirri
fusger1	Fusarium gerlachii
fusger2	Fusarium gerlachii
fusglo1	Fusarium globosum
fusgoo1	Fusarium goolgardi
fusgra10	Fusarium graminearum
fusgra11	Fusarium graminearum
fusgra12	Fusarium graminearum
fusgra2	Fusarium graminearum
fusgra3	Fusarium graminum
fusgra4	Fusarium graminearum
fusgra5	Fusarium graminearum
fusgra6	Fusarium graminearum
fusgra7	Fusarium graminearum
fusgra8	Fusarium graminearum
fusgra9	Fusarium graminearum
fusgut1	Fusarium guttiforme
fushae1	Fusarium haematococcum
fushae2	Fusarium haematococcum
fushae3	Fusarium haematococcum
fushai1	Fusarium hainanense
fushet1	Fusarium heterosporum
fushos1	Fusarium hostae
fushos2	Fusarium hostae
fushos3	Fusarium hostae
fushum1	Fusarium humuli
fushum2	Fusarium humuli
fusill1	Fusarium illudens
fusinc1	Fusarium incarnatum
fusinc2	Fusarium incarnatum
fusinc3	Fusarium incarnatum
fusirr1	Fusarium irregulare
fuskur1	Fusarium kuroshium
fuskyu1	Fusarium kyushuense
fuslan1	Fusarium langsethiae
fuslan2	Fusarium langsethiae
fuslan3	Fusarium langsethiae
fuslat1	Fusarium lateritium
fuslon1	Fusarium longipes
fuslon2	Fusarium longipes
fuslon3	Fusarium longipes
fuslon4	Fusarium longipes
fuslou1	Fusarium louisianense
fuslou2	Fusarium louisianense
fusluf1	Fusarium luffae
fuslya1	Fusarium lyarnte(nom.
fusman1	Fusarium mangiferae
fusman2	Fusarium mangiferae
fusman3	Fusarium mangiferae
fusmer1	Fusarium meridionale
fusmer2	Fusarium meridionale
fusmer3	Fusarium meridionale
fusmer4	Fusarium meridionale
fusmer5	Fusarium meridionale
fusmes1	Fusarium mesoamericanum
fusmet1	Fusarium metavorans
fusmex1	Fusarium mexicanum
fusmis1	Fusarium miscanthi
fusmun1	Fusarium mundagurra
fusmus1	Fusarium musae
fusmus2	Fusarium musae
fusnan1	Fusarium nanum
fusnap1	Fusarium napiforme
fusnel1	Fusarium nelsonii
fusnem1	Fusarium nematophilum
fusneo1	Fusarium neocosmosporiellum
fusnep1	Fusarium nepalense
fusnep2	Fusarium nepalense
fusnew1	Fusarium newnesense
fusnis1	Fusarium nisikadoi
fusnod1	Fusarium nodosum
fusnur1	Fusarium nurragi
fusnyg1	Fusarium nygamai
fusnyg2	Fusarium nygamai
fusnyg3	Fusarium nygamai
fusodo1	Fusarium odoratissimum
fusodo2	Fusarium odoratissimum
fusoxy17	Fusarium oxysporum
fusoxy18	Fusarium oxysporum
fusoxy19	Fusarium oxysporum
fusoxy2	Fusarium oxysporum
fusoxy21	Fusarium oxysporum
fusoxy22	Fusarium oxysporum
fusoxy23	Fusarium oxysporum
fusoxy24	Fusarium oxysporum
fusoxy25	Fusarium oxysporum
fusoxy26	Fusarium oxysporum
fusoxy28	Fusarium oxysporum
fusoxy29	Fusarium oxysporum
fusoxy3	Fusarium oxysporum
fusoxy30	Fusarium oxysporum
fusoxy32	Fusarium oxysporum
fusoxy33	Fusarium oxysporum
fusoxy34	Fusarium oxysporum
fusoxy35	Fusarium oxysporum
fusoxy36	Fusarium oxysporum
fusoxy37	Fusarium oxysporum
fusoxy38	Fusarium oxysporum
fusoxy40	Fusarium oxysporum
fusoxy42	Fusarium oxysporum
fusoxy43	Fusarium oxysporum
fusoxy44	Fusarium oxysporum
fusoxy45	Fusarium oxysporum
fusoxy46	Fusarium oxysporum
fusoxy52	Fusarium oxysporum
fusoxy53	Fusarium oxysporum
fusoxy54	Fusarium oxysporum
fusoxy55	Fusarium oxysporum
fusoxy56	Fusarium oxysporum
fusoxy57	Fusarium oxysporum
fusoxy58	Fusarium oxysporum
fuspal1	Fusarium palustre
fuspen1	Fusarium penzigii
fuspha1	Fusarium phaseoli
fuspha2	Fusarium phaseoli
fusphy1	Fusarium phyllophilum
fuspil1	Fusarium pilosicola
fuspin1	Fusarium pininemorale
fuspoa1	Fusarium poae
fuspoa2	Fusarium poae
fuspoa3	Fusarium poae
fuspoa4	Fusarium poae
fuspra1	Fusarium praegraminearum
fuspro1	Fusarium proliferatum
fuspro10	Fusarium proliferatum
fuspro11	Fusarium proliferatum
fuspro2	Fusarium proliferatum
fuspro3	Fusarium proliferatum
fuspro4	Fusarium proliferatum
fuspro5	Fusarium protoensiforme
fuspro6	Fusarium proliferatum
fuspro7	Fusarium proliferatum
fuspro8	Fusarium proliferatum
fuspro9	Fusarium proliferatum
fuspse1	Fusarium pseudograminearum
fuspse2	Fusarium pseudocircinatum
fuspse3	Fusarium pseudoanthophilum
fuspse4	Fusarium pseudograminearum
fuspse5	Fusarium pseudograminearum
fuspse6	Fusarium pseudonygamai
fuspse7	Fusarium pseudograminearum
fusram1	Fusarium ramigenum
fusred1	Fusarium redolens
fusred2	Fusarium redolens
fusred3	Fusarium redolens
fusred4	Fusarium redolens
fusred5	Fusarium redolens
fusrus1	Fusarium rusci
fussac1	Fusarium sacchari
fussac2	Fusarium sacchari
fussam1	Fusarium sambucinum
fussam2	Fusarium sambucinum
fussar1	Fusarium sarcochroum
fussci1	Fusarium scirpi
fussec1	Fusarium secorum
fusset1	Fusarium setosum
fussib1	Fusarium sibiricum
fussic1	Fusarium siculi
fussol1	Fusarium solani
fussol2	Fusarium solani
fussol3	Fusarium solani
fussol4	Fusarium solani
fussol5	Fusarium solani
fussor1	Fusarium sororula
fussp.10	Fusarium sp.
fussp.11	Fusarium sp.
fussp.2	Fusarium sp.
fussp.4	Fusarium sp.
fussp.5	Fusarium sp.
fussp.6	Fusarium sp.
fussp.7	Fusarium sp.
fussp.8	Fusarium sp.
fussp.9	Fusarium sp.
fusspo1	Fusarium sporotrichioides
fusspo2	Fusarium sporotrichioides
fusspo3	Fusarium sporotrichioides
fusspo4	Fusarium sporotrichioides
fussta1	Fusarium staphyleae
fusste1	Fusarium sterilihyphosum
fussti1	Fusarium stilboides
fussub1	Fusarium subglutinans
fussub2	Fusarium subtropicale
fussub3	Fusarium subglutinans
fussub4	Fusarium subglutinans
fussub5	Fusarium sublunatum
fussuc1	Fusarium succisae
fustan1	Fusarium tanahbumbuense
fustem1	Fusarium temperatum
fustem2	Fusarium temperatum
fustem3	Fusarium temperatum
fustem4	Fusarium temperatum
fustha1	Fusarium thapsinum
fustja1	Fusarium tjaetaba
fustor1	Fusarium torulosum
fustor2	Fusarium torreyae
fustra1	Fusarium transvaalense
fustri1	Fusarium tricinctum
fustri2	Fusarium tricinctum
fustri3	Fusarium tricinctum
fustri4	Fusarium tricinctum
fustri5	Fusarium tricinctum
fustri6	Fusarium tricinctum
fustri7	Fusarium tricinctum
fustri8	Fusarium tricinctum
fustua1	Fusarium tuaranense
fustuc1	Fusarium tucumaniae
fustuc2	Fusarium tucumaniae
fustuc3	Fusarium tucumaniae
fustup1	Fusarium tupiense
fusudu1	Fusarium udum
fusudu2	Fusarium udum
fususs1	Fusarium ussurianum
fususs2	Fusarium ussurianum
fususs3	Fusarium ussurianum
fususs4	Fusarium ussurianum
fusvan1	Fusarium vanettenii
fusven1	Fusarium venenatum
fusven2	Fusarium venenatum
fusven3	Fusarium ventricosum
fusven4	Fusarium venenatum
fusven5	Fusarium venenatum
fusven6	Fusarium venenatum
fusver1	Fusarium verticillioides
fusver2	Fusarium verticillioides
fusver3	Fusarium verticillioides
fusver4	Fusarium verticillioides
fusver5	Fusarium verticillioides
fusver6	Fusarium verrucosum
fusver7	Fusarium verticillioides
fusver8	Fusarium verticillioides
fusvet1	Fusarium veterinarium
fusvet2	Fusarium veterinarium
fusvir1	Fusarium virguliforme
fusvir2	Fusarium virguliforme
fusvir3	Fusarium virguliforme
fusvir4	Fusarium virguliforme
fusvir5	Fusarium virguliforme
fusvir6	Fusarium virguliforme
fusvir7	Fusarium virguliforme
fusvir8	Fusarium virguliforme
fusvir9	Fusarium virguliforme
fusvor1	Fusarium vorosii
fusvor2	Fusarium vorosii
fusxyl1	Fusarium xylarioides
fusxyl2	Fusarium xylarioides
fusxyl3	Fusarium xylarioides
fusxyl4	Fusarium xylarioides
fusxyl5	Fusarium xylarioides
fusxyl6	Fusarium xylarioides
fusxyl7	Fusarium xylarioides
fusxyl8	Fusarium xylarioides
fusxyl9	Fusarium xylarioides
fusxyr1	Fusarium xyrophilum
fusxyr2	Fusarium xyrophilum
fusxyr3	Fusarium xyrophilum
fuszan1	Fusarium zanthoxyli
fuszea1	Fusarium zealandicum
gaegra1	Gaeumannomyces graminis
gaetri1	Gaeumannomyces tritici
galmar1	Galerina marginata
galree1	Galactomyces reessii
gammul1	Gamsiella multidivaricata
gansin1	Ganoderma sinense
gansp.1	Ganoderma sp.
gaumor1	Gautieria morchelliformis
gelsub1	Gelatoporia subvermispora
geocan1	Geotrichum candidum
geocan2	Geotrichum candidum
geocan3	Geotrichum candidum
geocan4	Geotrichum candidum
geocan5	Geotrichum candidum
geocan6	Geotrichum candidum
geocan7	Geotrichum candidum
geocan8	Geotrichum candidum
geomor1	Geosmithia morbida
geopyr1	Geosiphon pyriformis
gigmar1	Gigaspora margarita
gigros1	Gigaspora rosea
glaloz1	Glarea lozoyensis
glaloz2	Glarea lozoyensis
glocer1	Glomus cerebriforme
glocon1	Gloeopeniophorella convolvens
gloste1	Glonium stellatum
glotra1	Gloeophyllum trabeum
gluame1	Glutinoglossum americanum
golcic1	Golovinomyces cichoracearum
golcic2	Golovinomyces cichoracearum
golcic3	Golovinomyces cichoracearum
golmag1	Golovinomyces magnicellulatus
gomame1	Gomphillus americanus
gonpro1	Gonapodya prolifera
grascr1	Graphis scripta
grocla1	Grosmannia clavigera
grycys1	Gryganskiella cystojenkinii
guynec1	Guyanagaster necrorhizus
gymand1	Gymnopus androsaceus
gymcon1	Gymnopus confluens
gymdil1	Gymnopilus dilepis
gymjun1	Gymnopilus junonius
gymlux1	Gymnopus luxurians
gyrliv1	Gyrodon lividus
halvar1	Halenospora varia
hammag1	Hamiltosporidium magnivora
hammag2	Hamiltosporidium magnivora
hamtva1	Hamiltosporidium tvaerminnensis
hamtva2	Hamiltosporidium tvaerminnensis
hangui1	Hanseniaspora guilliermondii
hanopu1	Hanseniaspora opuntiae
hanosm1	Hanseniaspora osmophila
hanuva1	Hanseniaspora uvarum
hanuva2	Hanseniaspora uvarum
hanval1	Hanseniaspora valbyensis
hapbis1	Haplosporangium bisporale
hapgra1	Haplosporangium gracile
hapsp.1	Haplosporangium sp.
hapsp.2	Haplosporangium sp.
hapsp.3	Haplosporangium sp.
hebcyl1	Hebeloma cylindrosporum
helgri1	Helicocarpus griseus
helsp.4	Helotiales sp.
helsul1	Heliocybe sulcata
heperi1	Hepatospora eriocheir
heralp1	Hericium alpestre
hesves1	Hesseltinella vesiculosa
hetspe1	Heterodermia speciosa
hexnit1	Hexagonia nitida
hirmin1	Hirsutella minnesotensis
hirrho1	Hirsutella rhossiliensis
hiscap1	Histoplasma capsulatum
hiscap10	Histoplasma capsulatum
hiscap3	Histoplasma capsulatum
hiscap4	Histoplasma capsulatum
hiscap5	Histoplasma capsulatum
hompol1	Homolaphlyctis polyrhiza
horaci1	Hortaea acidophila
hortha1	Hortaea thailandica
horwer1	Hortaea werneckii
horwer2	Hortaea werneckii
hyabic1	Hyaloscypha bicolor
hyahep1	Hyaloscypha hepaticicola
hyavar1	Hyaloscypha variabilis
hydfim1	Hydnopolyporus fimbriatus
hydpin1	Hydnomerulius pinastri
hydruf1	Hydnum rufescens
hygaur1	Hygrophoropsis aurantiaca
hymalb1	Hymenoscyphus albidus
hymfra1	Hymenoscyphus fraxineus
hymrad1	Hymenopellis radicata
hyparg1	Hypoxylon argillaceum
hypbur1	Hyphopichia burtonii
hypcer1	Hypoxylon cercidicola
hypcro1	Hypoxylon crocopeplum
hypfra1	Hypoxylon fragiforme
hypfus1	Hypoxylon fuscum
hyphym1	Hyphodiscus hymeniophilus
hypmar1	Hypsizygus marmoreus
hypmon1	Hypoxylon monticulosum
hyprub1	Hypoxylon rubiginosum
hyprub2	Hypoxylon rubiginosum
hypsp.1	Hypoxylon sp.
hypsp.10	Hypoxylon sp.
hypsp.2	Hypoxylon sp.
hypsp.3	Hypoxylon sp.
hypsp.4	Hypoxylon sp.
hypsp.5	Hypoxylon sp.
hypsp.6	Hypoxylon sp.
hypsp.7	Hypoxylon sp.
hypsp.8	Hypoxylon sp.
hypsp.9	Hypoxylon sp.
hypsub1	Hypoxylon submonticulosum
hypsub2	Hypholoma sublateritium
hyptru1	Hypoxylon trugodes
hyspul1	Hysterium pulicare
hyssto1	Hysterangium stoloniferum
ilydes1	Ilyonectria destructans
ilysp.1	Ilyonectria sp.
ilysp.2	Ilyonectria sp.
ilysp.3	Ilyonectria sp.
imsale1	Imshaugia aleurites
infgib1	Infundibulicybe gibba
irplac1	Irpex lacteus
isafum1	Isaria fumosorosea
jaaarg1	Jaapia argillacea
jamros1	Jaminaea rosea
jamsp.1	Jaminaea sp.
jimfla1	Jimgerdemannia flammicorona
jimfla2	Jimgerdemannia flammicorona
jimlac1	Jimgerdemannia lactiflua
kalbra1	Kalmanozyma brasiliensis
kalpfe1	Kalaharituber pfeilii
karrho1	Karstenula rhodostoma
kazafr1	Kazachstania africana
kazbar1	Kazachstania barnettii
kazbar2	Kazachstania barnettii
kazexi1	Kazachstania exigua
kaznag1	Kazachstania naganishii
kazsau1	Kazachstania saulgeensis
kazuni1	Kazachstania unispora
kludob1	Kluyveromyces dobzhanskii
klulac1	Kluyveromyces lactis
klumar2	Kluyveromyces marxianus
kocimp1	Kockovaella imperatae
kompas1	Komagataella pastoris
kompha1	Komagataella phaffii
kompha2	Komagataella phaffii
kompha4	Komagataella phaffii
kredeu1	Kretzschmaria deusta
kredeu2	Kretzschmaria deusta
kurcap1	Kuraishia capsulata
kwobes1	Kwoniella bestiolae
kwodej1	Kwoniella dejecticola
kwohev1	Kwoniella heveanensis
kwohev2	Kwoniella heveanensis
kwoman1	Kwoniella mangroviensis
kwoman2	Kwoniella mangroviensis
kwoman3	Kwoniella mangroviensis
kwosha1	Kwoniella shandongensis
lacame1	Laccaria amethystina
lacari1	Lachnellula arida
lacbic15	Laccaria bicolor
laccer1	Lachnellula cervina
laccf.1	Lactifluus cf.
laccf.2	Lactifluus cf.
lacdas1	Lachancea dasiensis
lacfer1	Lachancea fermentati
lachya1	Lachnellula hyalina
lacind1	Lactarius indigo
laclan1	Lachancea lanzarotensis
lacmey1	Lachancea meyersii
lacmir1	Lachancea mirantina
lacnot1	Lachancea nothofagi
lacocc1	Lachnellula occidentalis
lacpsa1	Lactarius psammicola
lacque1	Lachancea quebecensis
lacqui1	Lactarius quietus
lacsp.1	Lachancea sp.
lacsue1	Lachnellula suecica
lacthe1	Lachancea thermotolerans
lacwil1	Lachnellula willkommii
laesul1	Laetiporus sulphureus
laesul2	Laetiporus sulphureus
lanasi1	Lanmaoa asiatica
laspus1	Lasallia pustulata
laspus2	Lasallia pustulata
lasthe1	Lasiodiplodia theobromae
lasthe2	Lasiodiplodia theobromae
lasthe3	Lasiodiplodia theobromae
leclec1	Lecanicillium lecanii
leilac1	Leiotrametes lactinea
leimen1	Leiotrametes menziesii
leisp.1	Leiotrametes sp
lenedo1	Lentinula edodes
lenedo2	Lentinula edodes
lenedo7	Lentinula edodes
lenflu1	Lentithecium fluviatile
lentig1	Lentinus tigrinus
lentig2	Lentinus tigrinus
leosp.1	Leotiomycetes sp.
lepmac1	Leptosphaeria maculans
lepnud1	Lepista nuda
leppal1	Lepidopterella palustris
lepsor1	Lepista sordida
lepsp.1	Leptodontidium sp.
letcol1	Letharia columbiana
letlup1	Letharia lupina
leucre1	Leucosporidiella creatinivora
leucre2	Leucosporidium creatinivorum
leugon3	Leucoagaricus gongylophorus
leuleu1	Leucoagaricus leucothites
leumol1	Leucogyrophana mollusca
leusp.1	Leucoagaricus sp.
liccor1	Lichtheimia corymbifera
licram1	Lichtheimia ramosa
linelo2	Linnemannia elongata
linexi1	Linnemannia exigua
lingam1	Linnemannia gamsii
lingam2	Linnemannia gamsii
linhya1	Linnemannia hyalina
lining1	Lindgomyces ingoldianus
linpen1	Linderina pennispora
linrhi1	Lineolata rhizophorae
linsch1	Linnemannia schmuckeri
linzyc1	Linnemannia zychae
linzyc2	Linnemannia zychae
lipsta1	Lipomyces starkeyi
lizemp1	Lizonia empirigonia
lobtra1	Lobosporangium transversale
lodelo1	Lodderomyces elongisporus
lompro1	Lomentospora prolificans
lopmac1	Lophiostoma macrostomum
lopmyt1	Lophium mytilinum
lopnuc1	Lophiotrema nucula
lyoatr1	Lyophyllum atratum
macano1	Macroventuria anomochaeta
macful1	Macrolepiota fuliginosa
macpha1	Macrophomina phaseolina
macpha2	Macrophomina phaseolina
madmyc1	Madurella mycetomatis
magory1	Magnaporthe oryzae
magpoa1	Magnaporthiopsis poae
malglo1	Malassezia globosa
malpac1	Malassezia pachydermatis
malres1	Malassezia restricta
malres2	Malassezia restricta
malsym1	Malassezia sympodialis
malves1	Malassezia vespertilionis
marbru1	Marssonina brunnea
marcor1	Marssonina coronariae
marfia1	Marasmius fiardii
marore1	Marasmius oreades
masebu1	Massarina eburnea
maspha1	Massariosphaeria phaeospora
meimil1	Meira miltonrushii
melame1	Melampsora americana
melbic1	Meliniomyces bicolor
melbro1	Melanogaster broomeianus
melbro2	Melanogaster broomeanus
mellar1	Melampsora larici-populina
mellin1	Melampsora lini
melpul1	Melanomma pulvis-pyrius
melvar1	Meliniomyces variabilis
metacr1	Metarhizium acridum
metaff1	Metschnikowia aff.
metalb1	Metarhizium album
metani1	Metarhizium anisopliae
metani2	Metarhizium anisopliae
metani3	Metarhizium anisopliae
metbic2	Metschnikowia bicuspidata
metbic3	Metschnikowia bicuspidata
metbic4	Metschnikowia bicuspidata
metbru1	Metarhizium brunneum
metfru1	Metschnikowia fructicola
metgui1	Metarhizium guizhouense
methum1	Metarhizium humberi
metmaj1	Metarhizium majus
metper1	Metschnikowia persimmonesis
metril1	Metarhizium rileyi
metrob2	Metarhizium robertsii
metrob3	Metarhizium robertsii
metsp.2	Metschnikowia sp.
meygui1	Meyerozyma guilliermondii
meysp.1	Meyerozyma sp.
micbol1	Microdochium bolleyi
miccan1	Microsporum canis
micint1	Microbotryum intermedium
miclyc1	Microbotryum lychnidis-dioicae
micmic1	Microthyrium microscopicum
micsap1	Microbotryum saponariae
micsap2	Microbotryum saponariae
micsil1	Microbotryum silenes-dioicae
mictri1	Microdochium trichocladiopsis
milfar1	Millerozyma farinosa
mitdap1	Mitosporidium daphniae
mixosm1	Mixia osmundae
modren1	Modicella reniformis
moeant1	Moesziomyces antarcticus
moeant2	Moesziomyces antarcticus
moeaph1	Moesziomyces aphidis
moelib1	Moelleriella libera
molsco1	Mollisia scopiformis
moncan1	Monosporascus cannonballus
moncan2	Monosporascus cannonballus
monfru1	Monilinia fructicola
monfru2	Monilinia fructigena
monfru3	Monilinia fructicola
monhap1	Monacrosporium haptotylum
monibe1	Monosporascus ibericus
monlax1	Monilinia laxa
monper1	Moniliophthora perniciosa
monror1	Moniliophthora roreri
monsp.2	Monosporascus sp.
monsp.3	Monosporascus sp.
monsp.4	Monosporascus sp.
monsp.5	Monosporascus sp.
monsp.6	Monosporascus sp.
monsp.7	Monosporascus sp.
monsp.8	Monosporascus sp.
monvac1	Monilinia vaccinii-corymbosi
morant1	Mortierella antarctica
morant2	Mortierella antarctica
morcon1	Morchella conica
morelo2	Mortierella elongata
morelo3	Mortierella elongata
morhyg1	Mortierella hygrophila
morimp1	Morchella importuna
morimp2	Morchella importuna
morpol1	Mortierella polycephala
morsex1	Morchella sextelata
morsp.10	Mortierella sp.
morsp.11	Mortierella sp.
morsp.12	Mortierella sp.
morsp.13	Mortierella sp.
morsp.14	Mortierella sp.
morsp.15	Mortierella sp.
morsp.16	Mortierella sp.
morsp.4	Mortierella sp.
morsp.5	Mortierella sp.
morsp.6	Mortierella sp.
morsp.7	Mortierella sp.
morsp.8	Mortierella sp.
morsp.9	Mortierella sp.
mucamb1	Mucor ambiguus
muccir1	Mucor circinelloides
muccir2	Mucor circinatus
muccir3	Mucor circinelloides
mucend1	Mucor endophyticus
mucfus1	Mucor fuscus
muclan1	Mucor lanceolatus
muclus1	Mucor lusitanicus
muclus2	Mucor lusitanicus
mucmuc2	Mucidula mucida
mucplu1	Mucor plumbeus
mucrac1	Mucor racemosus
mucsat1	Mucor saturninus
muloch1	Multifurca ochricompacta
mycchl1	Mycena chlorophos
myceum1	Mycosphaerella eumusae
mycgal2	Mycena galopus
mycind2	Mycena indigotica
mycken1	Mycena kentingensis
mycthe1	Myceliophthora thermophila
mycven1	Mycena venus
myrdur1	Myriangium duriaei
mytres1	Mytilinidion resinicola
nadful1	Nadsonia fulvescens
naeenc1	Naematelia encephela
naeenc2	Naematelia encephala
nagliq1	Naganishia liquefaciens
nagvis1	Naganishia vishniacii
nakbac1	Nakaseomyces bacillisporus
nakdel1	Nakaseomyces delphensis
nakwic1	Nakazawaea wickerhamii
nangyp1	Nannizzia gypsea
naucas1	Naumovozyma castellii
naudai1	Naumovozyma dairenensis
nemabo1	Nemania abortiva
nemdif1	Nemania diffusa
nemdis1	Nematocida displodere
nempar1	Nematocida parisii
nempar2	Nematocida parisii
nemser1	Nemania serpens
nemser2	Nemania serpens
nemser3	Nemania serpens
nemsp.1	Nemania sp.
nemsp.2	Nemania sp.
nemsp.3	Nemania sp.
nemsp.4	Nematocida sp.
nemsp.5	Nematocida sp.
nemsp.6	Nematocida sp.
neoaci1	Neohortaea acidophila
neocal1	Neocallimastix californiae
neocla1	Neopestalotiopsis clavispora
neodit1	Neonectria ditissima
neofis1	Neosartorya fischeri
neoirr1	Neolecta irregularis
neoirr2	Neolecta irregularis
neolan1	Neocallimastix lanati
neolep1	Neolentinus lepideus
neopar1	Neofusicoccum parvum
neosp.3	Neopestalotiopsis sp.
neosp.5	Neocallimastix sp.
neucra3	Neurospora crassa
neucra4	Neurospora crassa
neutet1	Neurospora tetrasperma
neutet2	Neurospora tetrasperma
nosapi1	Nosema apis
nosbom1	Nosema bombycis
noscer1	Nosema ceranae
noscer10	Nosema ceranae
noscer3	Nosema ceranae
nosgra1	Nosema granulosis
obbriv1	Obba rivulosa
ogaang1	Ogataea angusta
ogaang10	Ogataea angusta
ogaang2	Ogataea angusta
ogaang3	Ogataea angusta
ogaang4	Ogataea angusta
ogaang5	Ogataea angusta
ogaang6	Ogataea angusta
ogaang7	Ogataea angusta
ogaang8	Ogataea angusta
ogaang9	Ogataea angusta
ogahag1	Ogataea haglerorum
ogahag10	Ogataea haglerorum
ogahag11	Ogataea haglerorum
ogahag12	Ogataea haglerorum
ogahag13	Ogataea haglerorum
ogahag14	Ogataea haglerorum
ogahag15	Ogataea haglerorum
ogahag16	Ogataea haglerorum
ogahag17	Ogataea haglerorum
ogahag18	Ogataea haglerorum
ogahag19	Ogataea haglerorum
ogahag2	Ogataea haglerorum
ogahag20	Ogataea haglerorum
ogahag21	Ogataea haglerorum
ogahag22	Ogataea haglerorum
ogahag3	Ogataea haglerorum
ogahag4	Ogataea haglerorum
ogahag5	Ogataea haglerorum
ogahag6	Ogataea haglerorum
ogahag7	Ogataea haglerorum
ogahag8	Ogataea haglerorum
ogahag9	Ogataea haglerorum
ogapar1	Ogataea parapolymorpha
ogaphi1	Ogataea philodendri
ogapol1	Ogataea polymorpha
ogathe1	Ogataea thermophila
oidmai1	Oidiodendron maius
oidneo1	Oidium neolycopersici
olipau1	Oliveonia pauxilla
olpbor1	Olpidium bornovanus
ompole1	Omphalotus olearius
ophaus1	Ophiocordyceps australis
ophcam1	Ophiocordyceps camponoti-rufipedis
ophcam2	Ophiocordyceps camponoti-leonardi
ophcam3	Ophiocordyceps camponoti-saundersi
ophcam4	Ophiocordyceps camponoti-floridani
ophdis1	Ophiobolus disseminans
ophkim1	Ophiocordyceps kimflemingae
ophnov1	Ophiostoma novo-ulmi
ophpic1	Ophiostoma piceae
ophpol1	Ophiocordyceps polyrhachis-furcata
ophsin1	Ophiocordyceps sinensis
ophsin2	Ophiocordyceps sinensis
ophuni1	Ophiocordyceps unilateralis
orboli1	Orbilia oligospora
orboli10	Orbilia oligospora
orboli11	Orbilia oligospora
orboli12	Orbilia oligospora
orboli13	Orbilia oligospora
orboli14	Orbilia oligospora
orboli15	Orbilia oligospora
orboli16	Orbilia oligospora
orboli17	Orbilia oligospora
orboli18	Orbilia oligospora
orboli19	Orbilia oligospora
orboli2	Orbilia oligospora
orboli20	Orbilia oligospora
orboli3	Orbilia oligospora
orboli4	Orbilia oligospora
orboli5	Orbilia oligospora
orboli6	Orbilia oligospora
orboli7	Orbilia oligospora
orboli8	Orbilia oligospora
orboli9	Orbilia oligospora
ordcol1	Ordospora colligata
orpsp.1	Orpinomyces sp.
oudmuc1	Oudemansiella mucida
pactan1	Pachysolen tannophilus
paeniv1	Paecilomyces niveus
paevar1	Paecilomyces variotii
paevar2	Paecilomyces variotii
paevar3	Paecilomyces variotii
pancya1	Panaeolus cyanescens
panpap1	Panaeolus papilionaceus
panrud1	Panus rudis
parbra1	Paracoccidioides brasiliensis
parbra2	Paracoccidioides brasiliensis
parchr1	Paraphoma chrysanthemicola
parchr2	Paraphoma chrysanthemicola
parlut1	Paracoccidioides lutzii
parmin1	Paraphaeosphaeria minitans
parnod1	Parastagonospora nodorum
parpol1	Parauncinula polyspora
parsac1	Paramicrosporidium saccamoebae
parspo1	Paraconiothyrium sporulosum
parspo2	Paraphaeosphaeria sporulosa
pasful1	Passalora fulva
patatr1	Patellaria atrata
paxade1	Paxillus adelphus
paxamm1	Paxillus ammoniavirescens
paxinv1	Paxillus involutus
paxrub1	Paxillus rubicundulus
pelfru1	Peltaster fructicola
penant1	Penicillium antarcticum
penari1	Penicillium arizonense
penbra1	Penicillium brasilianum
pencam1	Penicillium camemberti
penchr1	Penicillium chrysogenum
penchr2	Penicillium chrysogenum
pencop1	Penicillium coprophilum
pencru1	Penicillium crustosum
pendec1	Penicillium decumbens
pendig1	Penicillium digitatum
pendig2	Penicillium digitatum
penexp2	Penicillium expansum
penfla1	Penicillium flavigenum
penfre1	Penicillium freii
pengri1	Penicillium griseofulvum
pengri2	Penicillium griseofulvum
penita1	Penicillium italicum
penita2	Penicillium italicum
pennal1	Penicillium nalgiovense
pennor1	Penicillium nordicum
penoxa1	Penicillium oxalicum
penpol1	Penicillium polonicum
penrol1	Penicillium rolfsii
penroq1	Penicillium roqueforti
penrub1	Penicillium rubens
penrub2	Penicillium rubens
pensol2	Penicillium solitum
pensp.10	Penicillium sp.
pensp.11	Penicillium sp.
pensp.12	Peniophora sp.
pensp.14	Peniophora sp.
pensp.6	Peniophora sp.
pensp.7	Penicillium sp.
pensp.8	Penicillium sp.
pensp.9	Penicillium sp.
penste1	Penicillium steckii
pensub1	Penicillium subrubescens
penthy1	Penicillium thymicola
penvul1	Penicillium vulpinum
penzon1	Penicilliopsis zonata
permac1	Periconia macrospinosa
pesfic1	Pestalotiopsis fici
pessp.1	Pestalotiopsis sp.
petxyl1	Peterozyma xylosa
phaale1	Phaeoacremonium aleophilum
phacar1	Phanerochaete carnosa
phacar2	Phanerochaete carnosa
phachl1	Phaeomoniella chlamydospora
phachr2	Phanerochaete chrysosporium
phamin1	Phaeoacremonium minimum
phapoa1	Phaeosphaeria poagena
phasor1	Phanerochaete sordida
phasp.4	Phaeosphaeria sp.
phenox1	Phellinus noxius
phepou1	Phellinidium pouzarii
phiame1	Phialophora americana
phiatt1	Phialophora attae
phiatt2	Phialophora attinorum
phicur1	Phialemoniopsis curvata
phisco1	Phialocephala scopiformis
phisub1	Phialocephala subalpina
phlbre1	Phlebia brevispora
phlcen1	Phlebia centrifuga
phlcen2	Phlebia centrifuga
phlgig1	Phlebiopsis gigantea
phlsp.1	Phlebopus sp.
phoaln1	Pholiota alnicola
phocon1	Pholiota conissans
phomol1	Pholiota molesta
photra1	Phoma tracheiphila
phybla5	Phycomyces blakesleeanus
phycap6	Phyllosticta capitalensis
phycit11	Phyllosticta citricarpa
phycit12	Phyllosticta citrichinaensis
phycit13	Phyllosticta citribraziliensis
phycit14	Phyllosticta citriasiana
phypar2	Phyllosticta paracitricarpa
physp.1	Phyllosticta sp.
physte1	Physcia stellaris
pickud1	Pichia kudriavzevii
picmem1	Pichia membranifaciens
picpas1	Pichia pastoris
piehor1	Piedraia hortae
piloli1	Piloderma olivaceum
pipcyl1	Piptocephalis cylindrospora
pirfin1	Piromyces finnis
pirind1	Piriformospora indica
pirsp.2	Piromyces sp.
pismic1	Pisolithus microcarpus
pistin1	Pisolithus tinctorius
plecor1	Pleurotus cornucopiae
plecuc2	Plectosphaerella cucumerina
pleery1	Pleurotus eryngii
pleost1	Pleurotus ostreatus
pleost2	Pleurotus ostreatoroseus
pleost3	Pleurotus ostreatus
pleplu1	Plectosphaerella plurivora
plepul1	Pleurotus pulmonarius
plepul2	Pleurotus pulmonarius
plepul3	Pleurotus pulmonarius
plesip1	Pleomassaria siparia
pletra1	Plenodomus tracheiphilus
plicri1	Plicaturopsis crispa
plucer1	Pluteus cervinus
pnecan1	Pneumocystis canis
pnecar1	Pneumocystis carinii
pnejir1	Pneumocystis jirovecii
pnejir2	Pneumocystis jirovecii
pnemur1	Pneumocystis murina
pneory1	Pneumocystis oryctolagi
pnesp.1	Pneumocystis sp.
pnewak1	Pneumocystis wakefieldiae
pocchl2	Pochonia chlamydosporia
pocchl3	Pochonia chlamydosporia
podans1	Podospora anserina
podclo1	Podila clonocystis
podclo2	Podila clonocystis
podcom1	Podospora comata
podepi1	Podila epigama
podepi2	Podila epicladia
podepi3	Podila epicladia
podhor1	Podila horticola
podhor2	Podila horticola
podhum1	Podila humilis
podmin1	Podila minutissima
podmin2	Podila minutissima
podver1	Podila verticillata
podver2	Podila verticillata
podver3	Podila verticillata
podver4	Podila verticillata
polarc1	Polyporus arcularius
polbru1	Polyporus brumalis
polcit1	Polychaeton citri
polfus1	Polyplosphaeria fusca
polhys1	Polytolypa hystricis
polsqu1	Polyporus squamosus
porpun1	Poronia punctata
pospla1	Postia placenta
pospla2	Postia placenta
prolac1	Protomyces lactucaedebilis
prolac2	Protomyces lactucae-debilis
psaabe1	Psathyrella aberdarensis
pseant1	Pseudozyma antarctica
psedes1	Pseudogymnoascus destructans
pseeum1	Pseudocercospora eumusae
psefij1	Pseudocercospora fijiensis
pseflo1	Pseudozyma flocculosa
pseful1	Pseudocercospora fuligena
pseglu1	Pseudomicrostroma glucosiphilum
psehub1	Pseudozyma hubeiensis
psehyp1	Pseudovirgaria hyperparasitica
psemus1	Pseudocercospora musae
pseneu1	Pseudoloma neurophilia
psesp.10	Pseudogymnoascus sp.
psesp.11	Pseudogymnoascus sp.
psesp.12	Pseudogymnoascus sp.
psesp.13	Pseudogymnoascus sp.
psesp.14	Pseudogymnoascus sp.
psesp.15	Pseudogymnoascus sp.
psesp.16	Pseudogymnoascus sp.
psesp.17	Pseudogymnoascus sp.
psesp.18	Pseudogymnoascus sp.
psesp.2	Pseudogymnoascus sp.
psesp.20	Pseudogymnoascus sp.
psesp.21	Pseudogymnoascus sp.
psesp.22	Pseudogymnoascus sp.
psesp.3	Pseudogymnoascus sp.
psesp.4	Pseudogymnoascus sp.
psesp.5	Pseudogymnoascus sp.
psesp.6	Pseudogymnoascus sp.
psesp.8	Pseudogymnoascus sp.
psesp.9	Pseudogymnoascus sp.
psever1	Pseudogymnoascus verrucosus
psevex1	Pseudomassariella vexata
psevol1	Pseudotulostoma volvatum
psicf.1	Psilocybe cf.
psicub1	Psilocybe cubensis
psicya1	Psilocybe cyanescens
psiser1	Psilocybe serbica
ptegra1	Pterula gracilis
puccor4	Puccinia coronata
puccor5	Puccinia coronata
pucgra1	Puccinia graminis
pucgra2	Puccinia graminis
pucgra3	Puccinia graminis
pucgra4	Puccinia graminis
pucgra5	Puccinia graminis
pucgra6	Puccinia graminis
pucsor1	Puccinia sorghi
pucstr1	Puccinia striiformis
pucstr2	Puccinia striiformis
pucstr3	Puccinia striiformis
puctri1	Puccinia triticina
punstr1	Punctularia strigosozonata
purlil1	Purpureocillium lilacinum
pyccin2	Pycnoporus cinnabarinus
pyccoc2	Pycnoporus coccineus
pycpun1	Pycnoporus puniceus
pycsan1	Pycnoporus sanguineus
pyrcon1	Pyronema confluens
pyrgri1	Pyricularia grisea
pyrlyc1	Pyrenochaeta lycopersici
pyrnox1	Pyrrhoderma noxium
pyromp2	Pyronema omphalodes
pyrory1	Pyricularia oryzae
pyrory2	Pyricularia oryzae
pyrory3	Pyricularia oryzae
pyrory4	Pyricularia oryzae
pyrpen1	Pyricularia pennisetigena
pyrsem1	Pyrenophora seminiperda
pyrsp.1	Pyrenochaeta sp.
pyrsp.2	Pyricularia sp.
pyrsp.3	Pyrenochaeta sp.
pyrter1	Pyrenophora teres
pyrter2	Pyrenophora teres
pyrter3	Pyrenophora teres
pyrtri1	Pyrenophora tritici-repentis
pyrtri10	Pyrenophora tritici-repentis
pyrtri11	Pyrenophora tritici-repentis
pyrtri12	Pyrenophora tritici-repentis
pyrtri2	Pyrenophora tritici-repentis
pyrtri4	Pyrenophora tritici-repentis
pyrtri5	Pyrenophora tritici-repentis
pyrtri6	Pyrenophora tritici-repentis
pyrtri8	Pyrenophora tritici-repentis
pyrtri9	Pyrenophora tritici-repentis
racant1	Rachicladosporium antarcticum
racsp.1	Rachicladosporium sp.
ramcol1	Ramularia collo-cygni
ramrub1	Ramaria rubella
raseme1	Rasamsonia emersonii
rhesp.1	Rhexocercosporidium sp.
rhiazy1	Rhizopus azygosporus
rhicer1	Rhizophagus cerebriforme
rhicla1	Rhizophagus clarus
rhidel1	Rhizopus delemar
rhidel10	Rhizopus delemar
rhidel11	Rhizopus delemar
rhidel12	Rhizopus delemar
rhidel13	Rhizopus delemar
rhidel14	Rhizopus delemar
rhidel2	Rhizopus delemar
rhidel3	Rhizopus delemar
rhidel4	Rhizopus delemar
rhidel5	Rhizopus delemar
rhidel6	Rhizopus delemar
rhidel7	Rhizopus delemar
rhidel8	Rhizopus delemar
rhidel9	Rhizopus delemar
rhidia1	Rhizophagus diaphanus
rhieri1	Rhizoscyphus ericae
rhiglo1	Rhizoclosmatium globosum
rhiirr10	Rhizophagus irregularis
rhiirr12	Rhizophagus irregularis
rhiirr2	Rhizophagus irregularis
rhiirr3	Rhizophagus irregularis
rhiirr4	Rhizophagus irregularis
rhiirr5	Rhizophagus irregularis
rhiirr6	Rhizophagus irregularis
rhiirr7	Rhizophagus irregularis
rhiirr8	Rhizophagus irregularis
rhilig1	Rhizodiscina lignyota
rhimac1	Rhinocladiella mackenziei
rhimic2	Rhizopus microsporus
rhimic3	Rhizopus microsporus
rhimic4	Rhizopus microsporus
rhimic5	Rhizopus microsporus
rhimic6	Rhizopus microsporus
rhimic7	Rhizopus microsporus
rhiory1	Rhizopus oryzae
rhiory10	Rhizopus oryzae
rhiory11	Rhizopus oryzae
rhiory12	Rhizopus oryzae
rhiory13	Rhizopus oryzae
rhiory14	Rhizopus oryzae
rhiory15	Rhizopus oryzae
rhiory16	Rhizopus oryzae
rhiory17	Rhizopus oryzae
rhiory18	Rhizopus oryzae
rhiory19	Rhizopus oryzae
rhiory2	Rhizopus oryzae
rhiory20	Rhizopus oryzae
rhiory21	Rhizopus oryzae
rhiory22	Rhizopus oryzae
rhiory23	Rhizopus oryzae
rhiory24	Rhizopus oryzae
rhiory25	Rhizopus oryzae
rhiory26	Rhizopus oryzae
rhiory27	Rhizopus oryzae
rhiory28	Rhizopus oryzae
rhiory29	Rhizopus oryzae
rhiory3	Rhizopus oryzae
rhiory30	Rhizopus oryzae
rhiory31	Rhizopus oryzae
rhiory32	Rhizopus oryzae
rhiory33	Rhizopus oryzae
rhiory34	Rhizopus oryzae
rhiory35	Rhizopus oryzae
rhiory36	Rhizopus oryzae
rhiory37	Rhizopus oryzae
rhiory38	Rhizopus oryzae
rhiory39	Rhizopus oryzae
rhiory4	Rhizopus oryzae
rhiory5	Rhizopus oryzae
rhiory6	Rhizopus oryzae
rhiory7	Rhizopus oryzae
rhiory8	Rhizopus oryzae
rhiory9	Rhizopus oryzae
rhisol2	Rhizoctonia solani
rhisol3	Rhizoctonia solani
rhisol4	Rhizoctonia solani
rhisol5	Rhizoctonia solani
rhisol6	Rhizoctonia solani
rhisp.1	Rhizophagus sp.
rhisto1	Rhizopus stolonifer
rhives1	Rhizopogon vesiculosus
rhivin1	Rhizopogon vinicolor
rhobut2	Rhodocollybia butyracea
rhodio2	Rhodotorula diobovata
rhoglu1	Rhodosporidium glutinis
rhogra1	Rhodotorula graminis
rhogra2	Rhodotorula graminis
rhoros1	Rhodofomes roseus
rhosp.1	Rhodotorula sp.
rhosp.2	Rhodotorula sp.
rhotai1	Rhodotorula taiwanensis
rhotor1	Rhodosporidium toruloides
rhotor10	Rhodotorula toruloides
rhotor11	Rhodotorula toruloides
rhotor4	Rhodosporidium toruloides
rhotor5	Rhodosporidium toruloides
rhotor6	Rhodosporidium toruloides
rhotor7	Rhodotorula toruloides
rhotor8	Rhodotorula toruloides
rhotor9	Rhodotorula toruloides
rhyagr1	Rhynchosporium agropyri
rhycom1	Rhynchosporium commune
rhyruf1	Rhytidhysteron rufulum
rhysec1	Rhynchosporium secalis
ricfib1	Rickenella fibula
ricmel1	Rickenella mellea
rigmic1	Rigidoporus microporus
rosnec1	Rosellinia necatrix
roster1	Rostrohypoxylon terebratum
rozall1	Rozella allomycis
rozall2	Rozella allomycis
rusbre1	Russula brevipes
ruscom1	Russula compacta
rusdis1	Russula dissimulans
rusear1	Russula earlei
ruseme1	Russula emetica
rusoch1	Russula ochroleuca
rusrug1	Russula rugulosa
rusvin1	Russula vinacea
rutsp.1	Rutstroemia sp.
rutsp.2	Rutstroemia sp.
rutsp.3	Rutstroemia sp.
sacarb1	Saccharomyces arboricola
sacbou1	Saccharomyces boulardii
sacbou2	Saccharomyces boulardii
saccap1	Saccharomycopsis capsularis
saccer10	Saccharomyces cerevisiae
saccer100	Saccharomyces cerevisiae
saccer101	Saccharomyces cerevisiae
saccer102	Saccharomyces cerevisiae
saccer103	Saccharomyces cerevisiae
saccer104	Saccharomyces cerevisiae
saccer105	Saccharomyces cerevisiae
saccer106	Saccharomyces cerevisiae
saccer107	Saccharomyces cerevisiae
saccer108	Saccharomyces cerevisiae
saccer109	Saccharomyces cerevisiae
saccer11	Saccharomyces cerevisiae
saccer110	Saccharomyces cerevisiae
saccer111	Saccharomyces cerevisiae
saccer112	Saccharomyces cerevisiae
saccer113	Saccharomyces cerevisiae
saccer114	Saccharomyces cerevisiae
saccer115	Saccharomyces cerevisiae
saccer116	Saccharomyces cerevisiae
saccer117	Saccharomyces cerevisiae
saccer118	Saccharomyces cerevisiae
saccer119	Saccharomyces cerevisiae
saccer12	Saccharomyces cerevisiae
saccer120	Saccharomyces cerevisiae
saccer121	Saccharomyces cerevisiae
saccer13	Saccharomyces cerevisiae
saccer14	Saccharomyces cerevisiae
saccer15	Saccharomyces cerevisiae
saccer16	Saccharomyces cerevisiae
saccer17	Saccharomyces cerevisiae
saccer18	Saccharomyces cerevisiae
saccer19	Saccharomyces cerevisiae
saccer2	Saccharomyces cerevisiae
saccer20	Saccharomyces cerevisiae
saccer21	Saccharomyces cerevisiae
saccer22	Saccharomyces cerevisiae
saccer23	Saccharomyces cerevisiae
saccer24	Saccharomyces cerevisiae
saccer25	Saccharomyces cerevisiae
saccer26	Saccharomyces cerevisiae
saccer27	Saccharomyces cerevisiae
saccer28	Saccharomyces cerevisiae
saccer29	Saccharomyces cerevisiae
saccer3	Saccharomyces cerevisiae
saccer30	Saccharomyces cerevisiae
saccer31	Saccharomyces cerevisiae
saccer32	Saccharomyces cerevisiae
saccer33	Saccharomyces cerevisiae
saccer34	Saccharomyces cerevisiae
saccer35	Saccharomyces cerevisiae
saccer36	Saccharomyces cerevisiae
saccer37	Saccharomyces cerevisiae
saccer38	Saccharomyces cerevisiae
saccer39	Saccharomyces cerevisiae
saccer4	Saccharomyces cerevisiae
saccer40	Saccharomyces cerevisiae
saccer41	Saccharomyces cerevisiae
saccer42	Saccharomyces cerevisiae
saccer43	Saccharomyces cerevisiae
saccer44	Saccharomyces cerevisiae
saccer45	Saccharomyces cerevisiae
saccer46	Saccharomyces cerevisiae
saccer47	Saccharomyces cerevisiae
saccer48	Saccharomyces cerevisiae
saccer49	Saccharomyces cerevisiae
saccer5	Saccharomyces cerevisiae
saccer50	Saccharomyces cerevisiae
saccer51	Saccharomyces cerevisiae
saccer52	Saccharomyces cerevisiae
saccer53	Saccharomyces cerevisiae
saccer54	Saccharomyces cerevisiae
saccer55	Saccharomyces cerevisiae
saccer56	Saccharomyces cerevisiae
saccer57	Saccharomyces cerevisiae
saccer58	Saccharomyces cerevisiae
saccer59	Saccharomyces cerevisiae
saccer6	Saccharomyces cerevisiae
saccer60	Saccharomyces cerevisiae
saccer61	Saccharomyces cerevisiae
saccer62	Saccharomyces cerevisiae
saccer63	Saccharomyces cerevisiae
saccer64	Saccharomyces cerevisiae
saccer65	Saccharomyces cerevisiae
saccer66	Saccharomyces cerevisiae
saccer67	Saccharomyces cerevisiae
saccer68	Saccharomyces cerevisiae
saccer69	Saccharomyces cerevisiae
saccer7	Saccharomyces cerevisiae
saccer70	Saccharomyces cerevisiae
saccer71	Saccharomyces cerevisiae
saccer72	Saccharomyces cerevisiae
saccer73	Saccharomyces cerevisiae
saccer74	Saccharomyces cerevisiae
saccer75	Saccharomyces cerevisiae
saccer76	Saccharomyces cerevisiae
saccer77	Saccharomyces cerevisiae
saccer78	Saccharomyces cerevisiae
saccer79	Saccharomyces cerevisiae
saccer80	Saccharomyces cerevisiae
saccer81	Saccharomyces cerevisiae
saccer82	Saccharomyces cerevisiae
saccer83	Saccharomyces cerevisiae
saccer84	Saccharomyces cerevisiae
saccer85	Saccharomyces cerevisiae
saccer86	Saccharomyces cerevisiae
saccer87	Saccharomyces cerevisiae
saccer88	Saccharomyces cerevisiae
saccer89	Saccharomyces cerevisiae
saccer90	Saccharomyces cerevisiae
saccer91	Saccharomyces cerevisiae
saccer92	Saccharomyces cerevisiae
saccer93	Saccharomyces cerevisiae
saccer94	Saccharomyces cerevisiae
saccer95	Saccharomyces cerevisiae
saccer96	Saccharomyces cerevisiae
saccer97	Saccharomyces cerevisiae
saccer98	Saccharomyces cerevisiae
saccer99	Saccharomyces cerevisiae
saceub1	Saccharomyces eubayanus
sackud1	Saccharomyces kudriavzevii
saclud1	Saccharomycodes ludwigii
sacpar1	Saccharomyces paradoxus
sacpas1	Saccharomyces pastorianus
sacpro1	Saccharata proteae
sacsp.1	Saccharomycetaceae sp
saicom1	Saitoella complicata
saipod1	Saitozyma podzolica
saisp.1	Saitozyma sp.
sakvas1	Saksenaea vasiformis
sanbau1	Sanghuangporus baumii
saping1	Saprochaete ingens
satdis1	Saturnispora dispora
sceapi1	Scedosporium apiospermum
schcom6	Schizophyllum commune
schcry1	Schizosaccharomyces cryophilus
schjap1	Schizosaccharomyces japonicus
schoct1	Schizosaccharomyces octosporus
schpar1	Schizopora paradoxa
schpom1	Schizosaccharomyces pombe
schspa1	Scheffersomyces spartinae
schsti2	Scheffersomyces stipitis
sclbor1	Sclerotinia borealis
sclcep1	Sclerotium cepivorum
sclcit2	Scleroderma citrinum
sclscl1	Sclerotinia sclerotiorum
scltri1	Sclerotinia trifoliorum
scylig1	Scytalidium lignicola
scysp.2	Scytalidium sp.
sebver1	Sebacina vermifera
sepmus1	Septoria musiva
seppop1	Septoria populicola
serhim1	Serpula himantioides
serind2	Serendipita indica
serlac1	Serpula lacrymans
serlac2	Serpula lacrymans
serlac3	Serpula lacrymans
sersp.3	Serendipita sp.
sersp.4	Serendipita sp.
sersp.5	Serendipita sp.
sersp.6	Serendipita sp.
sersp.7	Serendipita sp.
sersp.8	Serendipita sp.
sersp.9	Serendipita sp.
server2	Serendipita vermifera
server3	Serendipita vermifera
sethol1	Setomelanomma holmii
settur2	Setosphaeria turcica
sisniv1	Sistotremastrum niveocremeum
sisniv2	Sistotremastrum niveocremeum
sissp.1	Sistotrema sp.
sissue1	Sistotremastrum suecicum
smiang1	Smittium angustum
smicul1	Smittium culicis
smicul2	Smittium culicis
smimeg1	Smittium megazygosporum
smimuc1	Smittium mucronatum
smisim1	Smittium simulii
sodalk1	Sodiomyces alkalinus
sorhum1	Sordaria humana
sormac1	Sordaria macrospora
sorsp.1	Sordaria sp.
spacri1	Sparassis crispa
spapas1	Spathaspora passalidarum
spasp.1	Spathaspora sp.
sphbru1	Sphaerosporella brunnea
sphmur1	Sphaceloma murrayae
sphmus1	Sphaerulina musiva
sphpal1	Sphagnurus paluster
sphste1	Sphaerobolus stellatus
spipun1	Spizellomyces punctatus
spisp.1	Spizellomyces sp.
spobra1	Sporothrix brasiliensis
spofim1	Sporormia fimetaria
spogra2	Sporisorium graminicola
spoins1	Sporothrix insectorum
sporei1	Sporisorium reilianum
sporei2	Sporisorium reilianum
sposal1	Sporidiobolus salmonicolor
sposch1	Sporothrix schenckii
sposch2	Sporothrix schenckii
sposci1	Sporisorium scitamineum
sposci2	Sporisorium scitamineum
sprlop1	Spraguea lophii
stacha1	Stachybotrys chartarum
stacha2	Stachybotrys chartarum
stacha3	Stachybotrys chartarum
stachl1	Stachybotrys chlorohalonata
staele1	Stachybotrys elegans
stalon1	Staphylotrichum longicolle
stanod1	Stagonospora nodorum
stasp.1	Stagonospora sp.
stehir1	Stereum hirsutum
stelyc1	Stemphylium lycopersici
steoch1	Steccherinum ochraceum
stynor1	Stylonectria norvegica
suglig1	Sugiyamaella lignohabitans
suhtan1	Suhomyces tanzawaensis
suiame1	Suillus americanus
suiamp1	Suillus ampliporus
suibov1	Suillus bovinus
suibre1	Suillus brevipes
suicf.3	Suillus cf.
suicli1	Suillus clintonianus
suicot1	Suillus cothurnatus
suidec1	Suillus decipiens
suidis1	Suillus discolor
suifus1	Suillus fuscotomentosus
suihir1	Suillus hirtellus
suilak1	Suillus lakei
suilut1	Suillus luteus
suiocc1	Suillus occidentalis
suipal1	Suillus paluster
suipla2	Suillus placidus
suiplo1	Suillus plorans
suispr1	Suillus spraguei
suisub1	Suillus subalutaceus
suisub2	Suillus subaureus
suisub3	Suillus subluteus
suitom1	Suillus tomentosus
suivar1	Suillus variegatus
suiwea1	Suillus weaverae
synend1	Synchytrium endobioticum
synend2	Synchytrium endobioticum
synmic1	Synchytrium microbalum
synpse1	Syncephalis pseudoplumigaleata
synrac1	Syncephalastrum racemosum
talame1	Talaromyces amestolkiae
talatr1	Talaromyces atroroseus
talbor1	Talaromyces borbonicus
talcel1	Talaromyces cellulolyticus
talisl1	Talaromyces islandicus
talmar1	Talaromyces marneffei
talmar2	Talaromyces marneffei
talpin1	Talaromyces pinophilus
talrug1	Talaromyces rugulosus
talsti1	Talaromyces stipitatus
talver1	Talaromyces verruculosus
tapdef1	Taphrina deformans
tepran1	Tephrocybe rancida
tepsp.1	Tephrocybe sp.
terbou1	Terfezia boudieri
tercla1	Terfezia claveryi
tercry1	Termitomyces cryptogamus
ternub1	Teratosphaeria nubilosa
tersp.3	Termitomyces sp.
tersp.4	Termitomyces sp.
tersp.5	Termitomyces sp.
tersp.6	Termitomyces sp.
tersp.7	Termitomyces sp.
tersp.8	Termitomyces sp.
tersp.9	Termitomyces sp.
tescyp1	Testicularia cyperi
tetbla1	Tetrapisispora blattae
tetnig1	Tetrapyrgos nigripes
tetpha1	Tetrapisispora phaffii
thacuc1	Thanatephorus cucumeris
thasph1	Thamnocephalis sphaerospora
thecon1	Thelohania contejeani
thegan1	Thelephora ganbajun
thelan1	Thermomyces lanuginosus
theter1	Thelephora terrestris
theter2	Thermothielavioides terrestris
theter3	Thermothielavioides terrestris
thethe1	Thermothelomyces thermophilus
thipun1	Thielaviopsis punctulata
thiter1	Thielavia terrestris
tilano1	Tilletiaria anomala
tilcar1	Tilletia caries
tilcon1	Tilletia controversa
tilind1	Tilletia indica
tillae1	Tilletia laevis
tillae2	Tilletia laevis
tilwal1	Tilletia walkeri
tilwas1	Tilletiopsis washingtonensis
tirniv1	Tirmania nivea
tolcap1	Tolypocladium capitatum
tolinf1	Tolypocladium inflatum
toloph1	Tolypocladium ophioglossoides
tolpar1	Tolypocladium paradoxum
torcas1	Tortispora caseinolytica
torcas2	Tortispora caseinolytica
tordel1	Torulaspora delbrueckii
torglo1	Torulaspora globosa
torhem1	Torrubiella hemipterigena
torsp.1	Torulaspora sp.
totfus1	Tothia fuscella
trabet1	Trametes betulina
tracer1	Trametopsis cervina
tracin1	Trametes cingulata
tracin2	Trametes cinnabarina
tracoc1	Trametes coccinea
tragib1	Trametes gibbosa
trahom1	Trachipleistophora hominis
tralju1	Trametes ljubarskyi
tramax1	Trametes maxima
tramey1	Trametes meyenii
trapol1	Trametes polyzona
trapub1	Trametes pubescens
traver1	Trametes versicolor
tremes1	Tremella mesenterica
tremes2	Tremella mesenterica
treper1	Trematosphaeria pertusa
tresp.1	Tremellales sp.
triaru1	Trichoderma arundinaceum
triasa1	Trichosporon asahii
triasa2	Trichosporon asahii
triasp1	Trichoderma asperelloides
triasp2	Trichoderma asperellum
triatr4	Trichoderma atrobrunneum
triatr5	Trichoderma atroviride
triben2	Trichophyton benhamiae
tribis1	Trichodelitschia bisporula
tribre1	Trichoderma brevicompactum
tricif1	Trichomonascus ciferrii
tricit1	Trichoderma citrinoviride
tricon1	Tricholomella constricta
tricor1	Trichoderma cornu-damae
triequ1	Trichophyton equinum
trifur1	Tricholoma furcatifolium
trigam1	Trichoderma gamsii
trigra1	Trichoderma gracile
trigri1	Trichocladium griseum
trigui1	Trichoderma guizhouense
triham1	Trichoderma hamatum
trihar3	Trichoderma harzianum
trihar4	Trichoderma harzianum
trihir1	Trichoglossum hirsutum
trihyb1	Trichophaea hybrida
triint1	Trichophyton interdigitale
triint2	Trichophyton interdigitale
trilen1	Trichoderma lentiforme
trilon2	Trichoderma longibrachiatum
trimat1	Tricholoma matsutake
trimen1	Trichophyton mentagrophytes
triole1	Trichosporon oleaginosus
tripar2	Trichoderma parareesei
triple1	Trichoderma pleuroti
triree1	Trichoderma reesei
triree2	Trichoderma reesei
triree3	Trichoderma reesei
triree4	Trichoderma reesei
trirub1	Trichophyton rubrum
trirub10	Trichophyton rubrum
trirub2	Trichophyton rubrum
trirub3	Trichophyton rubrum
trirub4	Trichophyton rubrum
trirub5	Trichophyton rubrum
trirub6	Trichophyton rubrum
trirub7	Trichophyton rubrum
trirub8	Trichophyton rubrum
trirub9	Trichophyton rubrum
trisem1	Trichoderma semiorbis
trisim1	Trichoderma simmonsii
trisou1	Trichophyton soudanense
triton1	Trichophyton tonsurans
triver1	Trichophyton verrucosum
trivio1	Trichophyton violaceum
trivir1	Trichoderma virens
truang1	Truncatella angustata
tubaes1	Tuber aestivum
tubbor1	Tuber borchii
tubbru1	Tuber brumale
tubind1	Tuber indicum
tubmag1	Tuber magnatum
tubmel2	Tuber melanosporum
tubrat1	Tubulinosema ratisbonensis
tulcal2	Tulasnella calospora
tulcal4	Tulasnella calospora
tulsp.10	Tulasnella sp.
tulsp.11	Tulasnella sp.
tulsp.12	Tulasnella sp.
tulsp.13	Tulasnella sp.
tulsp.14	Tulasnella sp.
tulsp.15	Tulasnella sp.
tulsp.3	Tulasnella sp.
tulsp.4	Tulasnella sp.
tulsp.5	Tulasnella sp.
tulsp.6	Tulasnella sp.
tulsp.7	Tulasnella sp.
tulsp.8	Tulasnella sp.
tulsp.9	Tulasnella sp.
umbpus1	Umbilicaria pustulata
umbvin1	Umbelopsis vinacea
uncree1	Uncinocarpus reesii
uncree2	Uncinocarpus reesii
ustbro1	Ustilago bromivora
usthor1	Ustilago hordei
ustmay1	Ustilago maydis
ustsha1	Ustilago shanxiensis
ustsp.1	Ustilago sp.
ustsp.2	Ustilago sp.
usttri1	Ustilago trichophora
ustvir1	Ustilaginoidea virens
valmal2	Valsa malicola
valmal3	Valsa mali
valmal4	Valsa mali
valsor1	Valsa sordida
vanhum1	Vanrija humicola
vanpol1	Vanderwaltozyma polyspora
varmin1	Vararia minispora
vavcul1	Vavraia culicis
venech1	Venustampulla echinocandica
veneff1	Venturia effusa
venina1	Venturia inaequalis
vennas1	Venturia nashicola
vennas2	Venturia nashicola
venpir1	Venturia pirina
veralf1	Verticillium alfalfae
verdah2	Verticillium dahliae
verdah3	Verticillium dahliae
verdah4	Verticillium dahliae
verdah5	Verticillium dahliae
verena1	Verruculina enalia
vergal1	Verruconis gallopava
verlon1	Verticillium longisporum
vernon1	Verticillium nonalfalfae
viopal1	Violaceomyces palustris
virvir1	Viridothelium virens
vitcor1	Vittaforma corneae
volvol2	Volvariella volvacea
walhed1	Wallemia hederae
walich1	Wallemia ichthyophaga
walmel1	Wallemia mellicola
wesorn1	Westerdykella ornata
whamic1	Whalleya microplaca
wicano1	Wickerhamomyces anomalus
wiccif1	Wickerhamomyces ciferrii
wicmuc1	Wickerhamomyces mucosus
wicpij1	Wickerhamomyces pijperi
wicsor1	Wickerhamiella sorbophila
wilmik1	Wilcoxina mikolae
wolcoc1	Wolfiporia cocos
xerbad1	Xerocomus badius
xylacu1	Xylaria acuta
xylarb1	Xylaria arbuscula
xylarb2	Xylaria arbuscula
xylbam1	Xylaria bambusicola
xylcf.1	Xylaria cf.
xylcf.2	Xylaria cf.
xylcub1	Xylaria cubensis
xylcur2	Xylaria curta
xyldig1	Xylaria digitata
xylfla1	Xylaria flabelliformis
xylgra1	Xylaria grammica
xylhev1	Xylona heveae
xylint1	Xylaria intraflava
xyllon1	Xylaria longipes
xylmul1	Xylaria multiplex
xylnig1	Xylaria nigripes
xylpal1	Xylaria palmicola
xylscr1	Xylaria scruposa
xylsp.10	Xylariomycetidae sp.
xylsp.11	Xylaria sp.
xylsp.12	Xylariaceae sp.
xylsp.13	Xylariaceae sp.
xylsp.14	Xylaria sp.
xylsp.15	Xylariaceae sp.
xylsp.16	Xylaria sp.
xylsp.17	Xylariaceae sp.
xylsp.18	Xylariaceae sp.
xylsp.19	Xylariaceae sp.
xylsp.2	Xylariaceae sp.
xylsp.20	Xylariales sp.
xylsp.3	Xylariaceae sp.
xylsp.4	Xylaria sp.
xylsp.5	Xylariaceae sp.
xylsp.6	Xylaria sp.
xylsp.8	Xylariomycetidae sp.
xylsp.9	Xylaria sp.
xyltel1	Xylaria telfairii
xylven1	Xylaria venustula
yamten1	Yamadazyma tenuis
yarlip10	Yarrowia lipolytica
yarlip11	Yarrowia lipolytica
yarlip12	Yarrowia lipolytica
yarlip13	Yarrowia lipolytica
yarlip3	Yarrowia lipolytica
yarlip4	Yarrowia lipolytica
yarlip5	Yarrowia lipolytica
yarlip6	Yarrowia lipolytica
yarlip7	Yarrowia lipolytica
yarlip8	Yarrowia lipolytica
yarlip9	Yarrowia lipolytica
yarsp.1	Yarrowia sp.
yarsp.2	Yarrowia sp.
yarsp.3	Yarrowia sp.
zalvar1	Zalerion varium
zancul1	Zancudomyces culisetae
zascel1	Zasmidium cellare
zoprhi1	Zopfia rhizophila
zygbai1	Zygosaccharomyces bailii
zygbai2	Zygosaccharomyces bailii
zygbai3	Zygosaccharomyces bailii
zygmel1	Zygosaccharomyces mellis
zygmra1	Zygotorulaspora mrakii
zygpar1	Zygosaccharomyces parabailii
zygrou1	Zygosaccharomyces rouxii
zymard1	Zymoseptoria ardabiliae
zymbre1	Zymoseptoria brevis
zympse1	Zymoseptoria pseudotritici
zymtri1	Zymoseptoria tritici
zymtri2	Zymoseptoria tritici
zymtri3	Zymoseptoria tritici
zymtri4	Zymoseptoria tritici
zymtri5	Zymoseptoria tritici
